天井	てんじょう	trần nhà, (giá) trần
井戸	いど	giếng nước
丼	どんぶり	bát tô
親子丼	おやこどん	món cơm gà và trứng trong bát tô
囲む	かこむ	bao quanh, vây quanh
周囲	しゅうい	chu vi xung quanh
範囲	はんい	phạm vi
雰囲気	ふんいき	bầu không khí
冗談	じょうだん	chuyện đùa, lời nói đùa
処置	しょち	xử lý, biện pháp xử lý
処分	しょぶん	xử phạt, vứt bỏ
対処	たいしょ	đối phó, xử trí
机	つくえ	cái bàn
司会	しかい	dẫn chương trình, MC
上司	じょうし	cấp trên, sếp
伺う	うかがう	đến thăm, hỏi thăm
台詞	せりふ	lời thoại
歌詞	かし	lời bài hát
動詞	どうし	động từ
詰める	つめる	nhét vào, lấp, dồn
見詰める	みつめる	nhìn chằm chằm
詰め込む	つめこむ	nhồi nhét, nhét đầy
缶詰	かんづめ	đồ hộp, thực phẩm đóng hộp, bị "nhốt" trong không gian kín
評論	ひょうろん	bình luận, phê bình mang tính phân tích
批評	ひひょう	phê bình, nhận xét, đánh giá
誤り	あやまり	lỗi sai, nhầm lẫn
誤解	ごかい	hiểu lầm, hiểu sai
布団	ふとん	nệm, chăn đệm kiểu Nhật
座布団	ざぶとん	đệm ngồi kiểu Nhật
商談	しょうだん	Bàn bạc, đàm phán
団体	だんたい	đoàn thể, tổ chức
応援団	おうえんだん	đội cổ vũ
検討	けんとう	cân nhắc, xem xét
詩人	しじん	nhà thơ, thi nhân
訪ねる	たずねる	ghé thăm, đến thăm
訪れる	おとずれる	đến thăm
訪問	ほうもん	việc thăm hỏi, chuyến thăm
脂肪	しぼう	mỡ, chất béo
寝坊	ねぼう	ngủ quên
坊っちゃん	ぼっちゃん	con trai (người khác), cậu ấm
双子	ふたご	cặp song sinh, sinh đôi
収める	おさめる	giành được, cất gọn
収入	しゅうにゅう	thu nhập
年収	ねんしゅう	thu nhập hằng năm
吸収	きゅうしゅう	hấp thụ, tiếp thu
収集	しゅうしゅう	thu thập, gom lại
収穫	しゅうかく	thu hoạch, gặt hái
伴う	ともなう	đồng hành, kéo theo, đi kèm
俳優	はいゆう	diễn viên
保険	ほけん	bảo hiểm
保険料	ほけんりょう	phí bảo hiểm
保護者	ほごしゃ	người bảo hộ, người giám
保守的	ほしゅてき	mang tính bảo thủ
保証	ほしょう	bảo hành, bảo đảm
仏	ほとけ	Phật, Đức Phật
仏教	ぶっきょう	Phật giáo
偉い	えらい	vĩ đại, giỏi
偶然	ぐぜん	ngẫu nhiên, tình cờ
貨物	かもつ	hàng hóa, hàng chuyên chở
通貨	つうか	tiền tệ
硬貨	こうか	tiền xu
賃貸	ちんたい	cho thuê
家賃	やちん	tiền thuê nhà
運賃	うんちん	cước phí vận chuyển
乗車賃	じょうしゃちん	tiền vé xe, phí đi xe
貿易	ぼうえき	giao dịch, trao đổi, thương mại
貧しい	まずしい	nghèo, túng thiếu
貧乏	びんぼう	sự nghèo khổ
貧困	ひんこん	nghèo khó, túng thiếu
貴重	きちょう	quý giá, quý báu
貴重品	きちょうひん	đồ quý, vật có giá trị
記者	きしゃ	quý công ty
賞金	しょうきん	tiền thưởng
金賞	きんしょう	giải vàng
受賞	じゅしょう	nhận thưởng, được trao giải
文学賞	ぶんがくしょう	giải thưởng văn học
鑑賞	かんしょう	thưởng thức, cảm thụ nghệ thuật
賞味期限	しょうみきげん	hạn sử dụng
損	そん	lỗ, tổn thất, thiệt
損得	そんとく	lỗ lãi, thiệt hơn
損失	そんしつ	tổn thất
損害	そんがい	thiệt hại, hư hại
捨てる	すてる	vứt, bỏ
使い捨て	つかいすて	dùng xong bỏ
切り捨てる	きりすてる	cắt bỏ, bỏ qua, (số) làm tròn xuống
投げ捨てる	なげすてる	ném bỏ, quăng bỏ
拾う	ひろう	nhặt, lượm
拍手	はくしゅ	vỗ tay, tràng pháo tay
担う	になう	gánh vác, đảm nhận
担ぐ	かつぐ	vác, khiêng
担任	たんにん	giáo viên chủ nhiệm
負担	ふたん	gánh nặng, chịu trách nhiệm
取る	とる	chụp ảnh, quay phim
撮影	さつえい	việc chụp ảnh, quay phim
技	わざ	kỹ thuật, kỹ năng
特技	とくぎ	kỹ năng đặc biệt
演技	えんぎ	diễn xuất, biểu diễn
競技	きょうぎ	cuộc thi đấu, trận đấu
抜く	ぬく	nhổ, rút, vượt qua
抜ける	ぬける	(tóc, răng) rụng, xì (hơi), thiếu sót
追い抜く	おいぬく	vượt qua, vượt mặt
扱う	あつかう	xử lý, đối xử, sử dụng
取り扱う	とりつかう	thao tác, xử lý, đối đãi
拒む	こばむ	từ chối, khước từ
拒否	きょひ	sự từ chối, bác bỏ
捕る	とる	bắt, bắt giữ
捕まる	つかまる	bị bắt, bị tóm
捕まえ	つかまえる	bắt, tóm
逮捕	たいほ	bắt giữ, bắt giam
換える	かえる	thay, đổi
言い換える	いいかえる	nói cách khác, diễn đạt lại
歓喜	かんき	thông gió, lưu thông không khí
交換	こうかん	trao đổi, đổi chác
転換	てんかん	chuyển đổi
変換	へんかん	biến đổi, đổi
抵抗	ていこう	kháng cự, đề kháng
抗体	こうたい	kháng thể
反抗	はんこう	phản kháng, chống đối
対抗	たいこう	đối kháng, ganh đua
拝見する	はいけんする	xem, nhìn
拡充	かくじゅう	mở rộng, tăng cường về nội dung
拡大	かくだい	phóng to, bành trướng
拡張	かくちょう	mở rộng, bành trướng
声援	せいえん	lời cổ vũ, tiếng hò reo động viên
応援	おうえん	cổ vũ, ủng hộ, hỗ trợ
支援	しえん	chi viện, hỗ trợ
援助	えんじょ	viện trợ, giúp đỡ
採る	とる	thu thập, hái, tuyển chọn
採集	さいしゅう	thu thập, sưu tầm
採用	さいよう	tuyển dụng, tiếp nhận
色彩	しきさい	màu sắc, sắc thái
多彩	たさい	đa dạng, nhiều màu sắc,
将来	しょうらい	tương lai
将棋	しょうぎ	cờ Shougi
牛乳	ぎゅうにゅう	sữa bò
乳製品	にゅうせいひん	sản phẩm từ sữa
礼	れい	lễ nghi, sự cảm ơn, chào hỏi
礼儀正しい	れいぎただしい	lễ phép, lịch sự, đúng mực
乱す	みだす	làm rối loạn, phá vỡ trật tự
乱れる	みだれる	bị rối loạn, bị xáo trộn
混乱	こんらん	hỗn loạn, rối rắm
乱暴	らんぼう	thô bạo, bạo lực, thiếu lễ độ
撃つ	うつ	bắn, đánh
攻撃	こうげき	tấn công, công kích
挙げる	あげる	nêu ra, giơ lên, tổ chức
選挙	せんきょ	cuộc bầu cử
丘	おか	đồi, gò đất
兵士	へいし	binh sĩ, người lính
兵器	へいき	vũ khí
浜	はま	bãi biển, bờ biển
横浜	よこはま	Yokohama
沖	おき	khơi, ngoài khơi
沖縄	おきなわ	Okinawa
河川	かせん	sông ngòi
沼	ぬま	đầm lầy
沼地	ぬまち	vùng đầm lầy
状況	じょうきょう	tình hình, hoàn cảnh
浴びる	あびる	tắm
浴衣	ゆかた	yukata (tên 1 trang phục truyền thống)
溶ける	とける	tan ra
溶け込む	とけこむ	hòa nhập, hòa tan vào
溶岩	ようがん	dung nham
汁	しる	nước súp, nước cốt
みそ汁	みそしる	canh miso
沈む	しずむ	chìm, lặn
浮かべる	うかべる	thả trôi, làm nổi, biểu lộ
浮かぶ	うかぶ	nổi, hiện lên
思い浮かぶ	おもいうかぶ	nhớ ra, nghĩ đến
泥	どろ	bùn
津波	つなみ	sóng thần
興味津々	きょうみしんしん	vô cùng quan tâm, hứng thú
漁業	ぎょぎょう	ngành ngư nghiệp
漁師	りょうし	ngư dân, người đánh cá
ハロン湾	はろんわん	vịnh Hạ Long
渡る	わたる	băng qua, đi qua
渡す	わたす	trao, đưa
見渡す	みわたす	nhìn bao quát, nhìn quanh
渡り鳥	わたりどり	chim di trú
湿る	しめる	ẩm, bị ướt
湿気	しっけ	hơi ẩm, độ ẩm
湿度	しつど	độ ẩm không khí
渇く	かわく	khát nước
清い	きよい	trong sạch, thuần khiết
清掃	せいそう	dọn dẹp/ vệ sinh sạch sẽ
清算	せいさん	thanh toán, thanh lý
清潔	せいけつ	sạch sẽ, thanh khiết
起床	きしょう	thức dậy
栄養	えいよう	dinh dưỡng
栄える	さかえる	hưng thịnh, phồn vinh
条件	じょうけん	điều kiện
条件付き	じょうけんつき	có điều kiện, kèm điều kiện
悪条件	あくじょうけん	điều kiện xấu, bất lợi
杉	すぎ	cây liễu sam
桜	さくら	cây/ hoa anh đào
梅	うめ	cây mơ, quả mơ
梅雨	つゆ	mùa mưa
梅雨明け	つゆあけ	kết thúc mùa mưa
枕	まくら	cái gối
柄	がら	hoa văn, họa tiết, tính cách, vóc dáng
人柄	ひとがら	tính cách, phẩm chất con người
棒	ぼう	cái gậy, thanh dài
人材	じんざい	nhân lực, nhân tài
材質	ざいしつ	chất liệu, tính chất vật liệu
素材	そざい	nguyên liệu, vật liệu thô
食材	しょくざい	nguyên liệu nấu ăn
分析	ぶんせき	phân tích
枯れる	かれる	héo, khô héo
枯らす	からす	làm cho héo, làm khô
柱	はしら	cột, trụ
枝	えだ	cành cây
舞	まい	tấm, miếng
核心	かくしん	trọng tâm, cốt lõi
植える	うえる	trồng (cây)
植わる	うわる	được trồng
植物	しょくぶつ	thực vật, cây cối
模様	もよう	mô hình, hoa văn
橋	はし	cây cầu
歩道橋	ほどうきょう	cầu vượt cho người đi bộ
南極	なんきょく	Nam Cực
消極的	しょうきょくてき	có tính tiêu cực, một cách tiêu cực
積極的	せっきょくてき	có tính tích cực, một cách tích cực
幼い	おさない	non nớt, trẻ con
用紙	ようち	ấu trĩ, chưa trưởng thành
幻想	げんそう	ảo tưởng
幻覚	げんかく	ảo giác
玄関	げんかん	sảnh, lối đi vào
率直	そっちょく	thẳng thắn, bộc trực
確率	かくりつ	xác suất
能率	のうりつ	hiệu quả, năng suất
合格率	ごうかくりつ	tỷ lệ đỗ
系統	けいとう	hệ thống, họ (bên nhà nội/ ngoại)
子孫	しそん	con cháu, hậu duệ
編む	あむ	đan, bện
編み物	あみもの	đồ đan
短編	たんぺん	tác phẩm ngắn (thơ ca, phim ảnh..)
編集	へんしゅう	biên tập
綿	わた	bông, sợi bông
縮れる	ちぢれる	xoắn, xoắn lại
圧縮	あっしゅく	nén, ép
恐縮	きょうしゅく	ngại ngùng, xấu hổ (khi làm phiền hoặc nhận được giúp đỡ)
縮小	しゅくしょう	thu nhỏ, giảm bớt
短縮	たんしゅく	rút ngắn, thu gọn
口紅	くちべに	son môi
紅葉	もみじ	cây phong lá đỏ, lá phong đỏ
納める	おさめる	nộp, giao, cất giữ
納得	なっとく	hiểu, chấp nhận
納期	のうき	thời gian giao hàng
納税	のうぜい	nộp thuế
紹介	しょうかい	giới thiệu
絡まる	からまる	bị rối, bị vướng
連絡先	れんらくさき	địa chỉ liên lạc
絶えず	たえず	liên tục, không ngừng
絶対	ぜったい	tuyệt đối
絶滅	ぜつめつ	tuyệt chủng
絶好調	ぜっこうちょう	trạng thái tuyệt vời, phong độ cao
単純	たんじゅん	đơn giản, dễ hiểu
純粋	じゅんすい	thuần khiết, trong sáng
継続	けいぞく	kế tục, kết nối
酸素	さんそ	oxi
素質	そしつ	tố chất
質素	しっそ	đơn giản, giản dị
要素	ようそ	yếu tố
素朴	そぼく	mộc mạc, ngây thơ
素直	すなお	thành thật, ngoan ngoãn
素人	しろうと	người mới, nghiệp dư
害	がい	tác hại
公害	こうがい	ô nhiễm công cộng
災害	さいがい	thảm họa
障害	しょうがい	chướng ngại, khuyết tật
毒	どく	chất độc, tiệt trùng
消毒	しょうどく	tiệt trùng
中毒	ちゅうどく	ngộ độc, nghiện
松	まつ	cây thông
窓側	まどがわ	bên cửa sổ, phía cửa sổ
窓際	まどぎわ	sát cửa sổ
総合	そうごう	tổng hợp
総売上	そううりあげ	tổng doanh thu
総選挙	そうせんきょ	tổng tuyển cử
総動員	そうどういん	huy động mọi người, huy động tất cả thành viên
意志	いし	ý chí, quyết tâm
志願	しがん	tình nguyện, đăng ký, khao khát,
志望	しぼう	nguyện vọng, mong muốn
恵み	めぐ	phúc lành, ân huệ
恩恵	おんけい	ân huệ, ơn nghĩa
知恵	ちえ	trí tuệ, sự thông minh
優れる	すぐれる	xuất sắc, vượt trội
優良	ゆうりょ	tốt, ưu tú
優勝	ゆうしょ	chiến thắng, vô địch
準優勝	じゅんゆうしょう	giải nhì, á quân
優先	ゆうせん	ưu tiên
最優先	さいゆうせん	ưu tiên hàng đầu
恐ろしい	おそろしい	đáng sợ, khủng khiếp
恐れる	おそれる	sợ hãi
恐れ	おそれ	nỗi sợ, sự lo lắng
恐怖	きょうふ	nỗi sợ hãi, kinh hoàng
状態	じょうたい	tình trạng, trạng thái
態度	たいど	thái độ
密	みつ	dày đặc
秘密	ひみつ	bí mật
快晴	かいせい	thời tiết quang đãng, trời đẹp
快速	かいそく	tốc độ nhanh, nhanh chóng
快調	かいちょう	trạng thái tốt, tiến triển tốt
快適	かいてき	thoải mái, dễ chịu
不快	ふかい	khó chịu, không thoải mái
不愉快	ふゆかい	khó chịu, không vui
怪しい	あやしい	đáng ngờ, kỳ lạ
怪我	けが	vết thương, bị thương
くやしい	くや	hối hận, tiếc nuối
後悔	こうかい	hối tiếc, ăn năn
不潔	ふけつ	bẩn thỉu, không sạch sẽ
簡潔	かんけつ	ngắn gọn, súc tích
契約	けいやく	hợp đồng
仮契約	かりけいやく	hợp đồng tạm thời
喫茶店	きっさてん	quán cà phê
喫煙	きつえん	hút thuốc
召し上がる	めしあがる	Xin mời dùng (kính ngữ của ăn, uống)
招く	まね	mời, rủ
招待	しょうたい	mời, lời mời
照る	てる	chiếu sáng, tỏa sáng
照らす	てらす	chiếu sáng, soi sáng
照明	しょうめい	chiếu sáng, ánh sáng
対照	たいしょう	so sánh, đối chiếu
参照	さんしょう	tham khảo
刑事	けいじ	cảnh sát hình sự, thanh tra
差別	さべつ	sự phân biệt, phân biệt đối
性別	せいべつ	giới tính
分別	ぶんべつ	phân biệt, phân loại
格別	かくべつ	đặc biệt, khác biệt
別荘	べっそう	biệt thự
別問題	べつもんだい	vấn đề khác
職業別	しょくぎょうべつ	phân theo nghề nghiệp
罰金	ばっきん	tiền phạt
刺す	さす	đâm, chọc, chích
刺さる	ささる	đâm, chích
印刷	いんさつ	sự in ấn
演劇	えんげき	kịch, diễn kịch
劇場	げきじょう	nhà hát, rạp hát
劇場版	げきじょうばん	phiên bản điện ảnh, bản chiếu rạp
削る	けずる	gọt, bào
刻む	きざむ	khắc, thái nhỏ
遅刻	ちこく	muộn, trễ
時刻表	じこくひょう	lịch trình, bảng giờ
彫刻	ちょうこく	điêu khắc
真剣	しんけん	đứng đắn, nghiêm chỉnh, nghiêm túc
姿	すがた	dáng vẻ, hình dáng
姿勢	しせい	tư thế; thái độ
容姿	ようし	dáng vẻ, ngoại hình
資料	しりょう	tài liệu, tư liệu
資格	しかく	quyền hạn, trình độ, tư cách, bằng cấp
資源	しげん	tài nguyên
資本	しほん	vốn, tiền vốn; tư bản
盗む	ぬす	trộm cắp
強盗	ごうとう	cướp, kẻ cướp, vụ cướp
盗難	とうなん	vụ trộm cắp
軟らかい	やわらかい	mềm, xốp
柔軟	じゅうなん	linh hoạt, mềm dẻo
欧米	おうべい	Âu, Mỹ
介護	かいご	chăm sóc, điều dưỡng
魚介類	ぎょかいるい	hải sản
企業	きぎょう	doanh nghiệp
大企業	だいきぎょう	doanh nghiệp lớn
大手企業	おおてきぎょう	doanh nghiệp lớn, công ty lớn
輪	わ	vòng, bánh xe
駐輪場	ちゅうりんじょう	bãi đỗ xe đạp
論ずる	ろんずる	bàn luận, thảo luận
議論	ぎろん	thảo luận, tranh luận
世論 / 世論	よろん/せろん	dư luận, ý kiến công chúng
理論	りろん	lý thuyết, học thuyết, lý luận
論文	ろんぶん	bài luận, luận văn
年齢	ねんれい	tuổi tác
高齢化	こうれいか	già hóa dân số
要領	ようりょう	ý chính, cốt lõi
元大統領	もとだいとうりょう	nguyên tổng thống
領収書	りょうしゅうしょ	biên lai, hóa đơn
頂く	いただ	nhận
頂点	ちょうてん	đỉnh, chóp, điểm cao nhất
額	がく	số tiền, giá trị
金額	きんがく	số tiền, giá trị tiền tệ
高額	こうがく	số tiền lớn, giá trị cao
総額	そうがく	tổng số tiền
半額	はんがく	một nửa giá
傾く	かたむく	nghiêng về, có thiên hướng, có khuynh hướng
頑張る	がんばる	cố gắng, nỗ lực
頑固	がんこ	bướng bỉnh, cứng đầu
児童	じどう	trẻ em, thiếu nhi
幼児	ようじ	trẻ sơ sinh, trẻ nhỏ
育児	いくじ	nuôi dưỡng trẻ, chăm sóc trẻ
～匹	ひき	đơn vị đếm cho động vật nhỏ như chó,mèo
兆	ちょう	nghìn tỷ
充実	じゅうじつ	đầy đủ, hoàn thiện, viên mãn
充電	じゅうでん	sạc điện
銃	じゅう	súng
統一	とういつ	thống nhất
政党	せいとう	đảng chính trị
野党	やとう	đảng đối lập
与党	よとう	đảng cầm quyền
鋭い	するどい	sắc, nhọn, sắc bén
競う	きそう	thi đấu, cạnh tranh
競技場	きょうぎじょう	sân thi đấu
競馬	けいば	đua ngựa
競争心	きょうそうし	tinh thần cạnh tranh
宇宙	うちゅう	vũ trụ
宝くじ	たからくじ	vé số, sổ xố
宝石	ほうせき	đá quý
宛てる	あてる	gửi, chuyển đến
宛先	あてさき	địa chỉ người nhận
宗教	しゅうきょう	tôn giáo
祭る	まつる	thờ cúng
壁際	かべぎわ	gần tường
間際	まぎわ	ngay trước khi, vào phút chót
帰り際	かえりぎわ	lúc về, khi ra về
寝際	ねぎわ	lúc chuẩn bị đi ngủ
別れ際	わかれぎわ	lúc chia tay
投票	とうひょう	bầu cử, bỏ phiếu
投票率	とうひょうりつ	tỷ lệ bỏ phiếu
目標	もくひょう	mục tiêu
標準	ひょうじゅん	tiêu chuẩn
旧暦	きゅうれき	Lịch cũ, Âm lịch
旧正月	きゅうしょうがつ	Tết âm lịch ,( tết việt nam)
旧制度	きゅうせいど	chế độ cũ ,hệ thống cũ
初旬	しょじゅん	đầu tháng ( げっしょ)(月初）
下旬	げじゅん	cuối tháng
上旬	じょうじゅん	đầu tháng (10 ngày đầu tháng)
中旬	ちゅうじゅん	giữa tháng
昇る	のぼる	lên, tăng lên
上昇	じょうしょう	tăng lên vọt lên
急上昇	きゅうじょうしょう	tăng vọt, tăng nhanh
更ける	ふける	trở lên muộn, đêm khuya
更新	こうしん	cập nhật,đổi mới
変更	へんこう	thay đổi
凍る	こおる	đông cứng, đóng băng
凍える	こごえる	lạnh cóng, đông lạnh
冷凍	れいとう	làm lạnh, làm đông lạnh
乾く	かわく	khô, ráo
乾かす	かわかす	làm khô, phơi khô
乾燥	かんそう	sự khô ráo, sự làm khô
乾杯	かんぱい	cụng ly, chúc mừng
署名	しょめい	chữ ký
部署	ぶしょ	phòng ban, bộ phận
消防署	しょうぼうしょ	trạm cứu hoả
著しい	いちじるしい	nổi bật, rõ ràng
著者	ちょしゃ	tác giả
著書	ちょしゃ	sách, tác phẩm
内緒	ないしょ	bí mật, riêng tư
顕微鏡	けんびきょう	kính hiểm vi
境	さかい	ranh giới; giới hạn; biên giới
境界	きょうかい	biên giới, ranh giới tổ quốc, biên cương
国境	こっきょう	biên giới quốc gia
境目	さかいめ	ranh giới, điểm phân chia
心境	しんきょう	tâm trạng, cảm xúc
記憶	きおく	ký ức, trí nhớ
一億	いちおく	một trăm triệu yên
文章	ぶんしょう	bài văn, đoạn văn
組織	そしき	tổ chức
響く	ひびく	vang vọng, ảnh hưởng
影響	えいきょう	ảnh hưởng
悪影響	あくえいきょう	ảnh hưởng xấu
景色	けしき	cảnh vật, phong cảnh
情景	じょうけい	cảnh tượng, quang cảnh
景気	けいき	tình hình kinh tế
背景	はいけい	bối cảnh, nền tảng
影	かげ	bóng, bóng dáng
撮影	さつえい	quay phim, chụp ảnh
涼し	すずしい	mát mẻ
就く	つく	bắt đầu, đảm nhiệm, làm công việc
就任	しゅうにん	nhận chức,lên chức
就職率	しゅうしょくりつ	tỷ lệ có viẹc làm
寮	りょう	ký túc xá
医療	いりょう	y tế
治療	ちりょう	chữa trị,điều trị
同僚	どうりょう	đồng nghiệp
巣	す	tổ, ổ
お菓子	おかし	kẹo bánh ngọt
洋菓子	ようがし	bánh kẹo Phương Tây
和菓子	わがし	bánh kẹo truyền thống Nhật Bản
課す	かす	giao, áp đặt
課題	かだい	bài tập về nhà, chủ đề, đề tài, vấn đề, nhiệm vụ
専門	せんもん	chuyên môn
専用	せんよう	dành riêng, chuyên dụng
専攻	せんこう	chuyên ngành
専属	せんぞく	thuộc về, chuyên trách
博士	はかせ	tiến sĩ ,học giả
博士	はくし	tiến sĩ, học giả(cách đọc khi đi cùng hoặc liên quan đến học vị)
博物館	はくぶつかん	bảo tàng
薄い	うすい	mỏng nhạt
薄暗い	うすぐらい	mờ, u ám , âm u
薄い明るい	うすあかるい	lờ mờ sáng
薄れる	うすれる	làm loãng, làm nhạt
薄める	うすめる	nhạt đi, phai nhạt
薄っぺら	うすっぺら	mỏng manh, hời hợt
薄味	うすあじ	vị nhạt
憎い	にくい	đáng ghét, căm ghét
憎らしい	にくらしい	đáng ghét, làm người ta căm phẫn
憎む	にくむ	căm thù, ghét bỏ
贈る	おくる	tặng quà
一層	いっそう	hơn nữa,càng thêm
高層	こうそう	cao tầng
高層マンション	こうそうまんしょん	chung cư cao tầng
差異	さい	khác biệt,sự khác nhau
異常	いじょう	bất thường,bất ổn
異国	いこく	nưới ngoài,quốc gia khác
異色	いしょく	khác biệt,độc đáo
異文化	いぶんか	văn hoá khác biệt
異分野	いぶんや	lĩnh vực khác biệt
畳む	たたむ	gấp,xếp lại
畳	たたみ	chiếu tatami ( một loại chiếu truyền thống của Nhật Bản)
折り畳み傘	おりたたみがさ	ô gấp ,ô du lịch
〜畳	〜じょう	đơn vị đo diện tích,dùng cho các gian phòng kiểu Nhật
鼻水	はなみず	nước mũi
略す	りゃくす	rút gọpn ,tóm gọn
省略	しょうりゃく	lược bỏ,rút gọn
簡略	かんりゃく	đơn giản hoá,giản lược
戦略	せんりゃく	chiến lược
家畜	かちく	gia súc
雷	かみなり	sấm sét
児童	じどう	trẻ em,thiếu nhi
童話	どうわ	chuyện cổ tích, đồng thoại
埋まる	うまる	bị chôn, lấp đầy
埋める	うめる	chôn, lấp đầy
福	ふく	phúc, may mắn
幅	はば	chiều rộng, bề rộng
大幅	おおはば	rộng lớn, đáng kể
副詞	ふくし	trạng từ
副作用	ふくさよう	tác dụng phụ
副社長	ふくしゃちょう	phó giám đốc
副大臣	ふくだいじん	phó bộ trưởng, thứ trưởng
咲く	さく	nở hoa
叫ぶ	さけぶ	kêu la, la hét
吐く	はく	nôn, ói
吐き気	はきけ	cảm giác buồn nôn
占い	うらない	bói toán,dự đoán
占う	うらなう	bói, dự đoán
占める	しめる	chiếm, nắm giữ
独占	どくせん	độc chiếm, độc quyền
含める	ふくめる	bao gồm
環境	かんきょう	môi trường hoàn cảnh
指摘	してき	chỉ ra chỉ trích
滴る	したたる	rơi nhỏ hạt, rỏ xuống
点滴	てんてき	truyền dịch, nhỏ giọt
敵	てき	kẻ thù, đối thủ
素敵	すてき	đáng yêu, tuyệt vời, đẹp
硬い	かたい	cứng rắn
砂	すな	cát
砂漠	さばく	sa mạc
周り	まわり	xung quanh,vây quanh
周囲	しゅうい	vùng xung quanh, phạm vi, chu vi
周辺	しゅうへん	khu vực xung quanh,vùng lân cận
彫る	ほる	khắc,chạm khắc
距離	きょり	khoảng cách ,cự ly
踊る	おどる	nhảy múa
踊り	おどり	múa, điệu múa, điệu nhảy
実践	じっせん	thực tiễn, thực hành, áp dụng vào thực tế
望遠鏡	ぼうえんきょう	kính thiên văn
含む	ふくむ	bao gồm, chứa đựng
お勧め	おすすめ	sự giới thiệu, khuyến nghị
勧める	すすめ	đề nghị, khuyên
勧誘	かんゆう	mời gọi, dụ dỗ
権利	けんり	quyền lợi, quyền hạn
洗濯機	せんたくき	máy giặt
洗濯物	せんたくもの	đồ giặt
焦げる	こげる	bị cháy, bị khê
焦る	あせる	hoảng hốt, vội vã
焦点	しょうてん	tiêu điểm
基準	きじゅん	tieu chuẩn, chuẩn mực
水準	すいじゅん	mức độ, tiêu chuẩn
高水準	こうすいじゅん	tiêu chuẩn cao
準決勝	じゅんけっしょう	trận bán kết
携帯電話	けいたいでんわ	điện thoại di động
雇う	やとう	thuê mướn
催し	もよおし	sự kiện, buổi lễ
開催	かいさい	khai mạc, tổ chức
看護	かんご	điều dưỡng
看護師	かんごし	y tá, điều dưỡng viên
弁護士	べんごし	luật sư
暮らす	くらす	sinh sống
暮らし	くらし	cuộc sống
一人暮らし	ひとりぐらし	sống một mình
暮れ	くれ	hoàng hôn, cuối
荒い	あらい	khốc liệt, thô bạo, dữ dội
工芸	こうげい	nghệ thuật thủ công
芸能界	げいのうかい	giới giải trí
並ぶ	ならぶ	xếp hàng, ngang hàng
並べる	ならべる	sắp xếp, bày ra
並木	なみき	hàng cây
立ち並ぶ	たちならぶ	đứng xếp thành hàng
僕	ぼく	tôi
敬う	うやまう	tôn trọng
敬意	けいい	lòng kính trọng
敬語	けいご	kính ngữ
尊敬	そんけい	tôn kính
警告	けいこく	cảnh báo
警備	けいび	an ninh, bảo vệ
警察署	けいさつしょ	đồn cảnh sát
驚く	おどろく	ngạc nhiên, bất ngờ
驚き	おどろき	sự ngạc nhiên
驚かす	おどろかす	làm cho ngạc nhiên
殴る	なぐる	đấm
殺す	ころす	giết
殺菌	さっきん	sát khuẩn
自殺	じさつ	tự sát
殿	どの	ngài
宮殿	きゅうでん	cung điện
施設	しせつ	cơ sở, cơ sở vật chất
設計	せっけい	thiết kế
設置	せっち	cài đặt, thành lập
設定	せってい	cài đặt, thiết lập
皮	かわ	vỏ, da
皮膚	ひふ	da
皮肉	ひにく	châm biếm
破る	やぶる	làm rách, phá vỡ
破れる	やぶれる	bị rách, bị hỏng
破片	はへん	mảnh vỡ
破産	はさん	phá sản
被害	ひがい	thiệt hại
大被害	だいひがい	tổn thất lớn
腕	うで	cánh tay, kỹ năng
肌	はだ	da
背負う	せおう	gánh vác, cõng
背景	はいけい	bối cảnh, nền tảng
骨	ほね	xương
骨折	こっせつ	gãy xương
肩	かた	vai
胸	むね	ngực
脳	のう	não
頭脳	ずのう	trí tuệ
悩む	なやむ	buồn phiền
悩み	なやみ	sự phiền muộn
離す	はなす	thả, tách ra
離れる	はなれる	rời đi, tách ra
引き離す	ひきはなす	tách tời ra. kéo ra xa
活字離れ	かつじばなれ	giảm đọc sách
現実離れ	げんじつばなれ	xa rời thực tế
誰か	だれか	ai đó
幼稚	ようち	trẻ con, ấu trĩ
居眠り	いねむり	ngủ gật
居心地	いごこち	cảm giác thoải mái khi ở đâu đó
芝居	しばい	vở diễn, kịch
同居	どうきょ	sống chung
住居	じゅうきょ	nơi ở
発展	はってん	phát triển
展示会	てんじかい	buổi triển lãm, trưng bày
展覧会	てんらんかい	buổi triển lãm
属す	ぞくす	thuộc về
所属	しょぞく	sự thuộc về
専属	せんぞく	chuyên trách
付属	ふぞく	phụ thuộc, kèm theo
金属	きんぞく	kim loại
退屈	たいくつ	nhàm chán
掘る	ほる	đào
堀	ほり	rãnh, hào
辛い	からい	cay (辛い：nếu đọc つらい thì là đau đớn, khó khăn)
避ける	さける	trốn tránh
避難	ひなん	lánh nạn, sơ tán
壁	かべ	tường
封筒	ふうとう	bao thư
開封	かいふう	mở bao thư
掛かる	かかる	tốn/mất; vướng vào; bị treo; bị ảnh hưởng/
掛ける	かける	phụ thuộc
追い掛ける	おいかける	đuổi theo
話し掛ける	はなしかける	bắt chuyện, nói chuyện
取り掛かる	とりかかる	bắt tay vào làm
引っ掛かる	ひっかかる	bị mắc, bị vướng
街	まち	khu phố
街角	まちかど	góc phố
オフィス街	オフィスがい	khu văn phòng
商店街	しょうてんがい	khu chợ, phố mua sắm
住宅街	じゅうたくがい	khu dân cư
至る	いたる	tới, đạt đến
一致	いっち	sự đồng loạt, đồng nhất
握る	にぎる	nắm, bắt
握手	あくしゅ	bắt tay
超過	ちょうか	vượt quá, quá mức
引っ越し	ひっこし	chuyển nhà
追い越す	おいこす	vượt qua, vượt lên
乗り越す	のりこす	lỡ trạm, vượt qua điểm dừng
趣味	しゅみ	sở thích
垂れる	たれる	rủ xuống, chảy xuống, nhỏ giọt / ban cho
垂直	すいちょく	sự vuông góc,thẳng đứng
睡眠	すいみん	giấc ngủ
牧場	ぼくじょう	nông trại, trang trại chăn nuôi
攻める	せめる	tấn công
選考	せんこう	chuyên ngành
放す	はなす	thả, buông
放れる	はなれる	thoát ra, được thả ra
放り出す	ほうりだす	ném ra, đẩy ra
解放	かいほう	giải phóng, giải thoát
放棄	ほうき	từ bỏ, bỏ rơi
解放感	かいほうかん	cảm giác tự do, thoải mái
食べ放題	たべほうだい	ăn tự do, thoải mái
激しい	はげしい	mãnh liệt, quyết liệt
刺激	しげき	kích thích
徹夜	てつや	thức suốt đêm
徹底的	てっていてき	triệt để, hoàn toàn
特徴	とくちょう	đặc điểm, đặc trưng
象徴的	しょうちょうてき	biểu tượng, biểu trưng
衛生	えいせい	vệ sinh
衛星	えいせい	vệ tinh
人工衛星	じんこうえいせい	vệ tinh nhân tạo
往復	おうふく	khứ hồi
往来	おうらい	đường phố, sự qua lại
従う	したがう	tuân theo, vâng lời
服従	ふくじゅう	phục tùng, tuân lệnh
従業員	じゅうぎょういん	nhân viên
縦書き	たてがき	viết dọc, viết theo chiều dọc
縦	たて	chiều dọc, hàng dọc
兼ねる	かねる	kiêm, kết hợp, không thể
謙遜	けんそん	khiêm nhường, khiêm tốn
謙虚	けんきょ	khiêm tốn, nhún nhường
嫌う	きらう	ghét, không thích
嫌がる	いやがる	ghét, không thích ai đó làm điều gì
好き嫌い	すききらい	thích và không thích
機嫌	きげん	tâm trạng, sắc mặt
旧姓	きゅうせい	họ cũ, họ thời con gái
妊娠	にんしん	mang thai
妊婦	にんぷ	thai phụ
宴会	えんかい	tiệc, bữa tiệc
届く	とどく	đến nơi, được chuyển đến
届ける	とどける	gửi đến, chuyển đến
抽選	ちゅうせん	rút thăm, xổ số
抽象的	ちゅうしょうてき	xa vời, một cách trừu tượng
暴く	あばく	vạch trần, phơi bày
暴れる	あばれる	nổi giận, làm ầm ĩ
暴行	ぼうこう	hành hung, tấn công
暴力	ぼうりょく	bạo lực
爆発	ばくはつ	nổ, vụ nổ
電灯	でんとう	đèn điện
灯台	とうだい	hải đăng
乾燥	かんそう	sự khô, làm khô
防災	ぼうさい	phòng chống thảm họa, thiên tai
火災	かさい	hỏa hoạn, vụ cháy
災難	さいなん	tai nạn, rủi ro
灰	はい	tro
灰色	はいいろ	màu xám
炭	すみ	than
二酸化炭素	にさんかたんそ	CO2
缶	かん	lon
崩す	くずす	sụp, vỡ; đổi tiền
崩れる	くずれる	phá vỡ, làm đổ
岸	きし	bờ, bãi
端	はし	đầu, cạnh, mép
先端	せんたん	mũi nhọn, rìa bên ngoài, đi đầu, tiên tiến
粒	つぶ	hạt, viên, hạt nhỏ
粉	こな	bột, phấn
花粉症	かふんしょう	dị ứng phấn hoa
精神	せいしん	tinh thần, tâm trí
精一杯	せいいっぱい	hết sức, hết mình
精々	せいぜい	tối đa, nhiều nhất
化粧	けしょう	trang điểm
化粧品	けしょうひん	mỹ phẩm
季節	きせつ	mùa, mùa trong năm
四季	しき	bốn mùa
香り	かおり	hương, mùi thơm
香水	こうすい	nước hoa
稼ぐ	かせぐ	kiếm tiền, làm việc để kiếm sống
委員	いいん	thành viên ủy ban
委任状	いにんじょう	giấy ủy quyền
優秀	ゆうしゅう	xuất sắc, ưu tú
誘う	さそう	mời, rủ
証拠	しょうこ	chứng cứ
保証金	ほしょうきん	tiền bảo lãnh, tiền đặt cọc
暗証番号	あんしょうばんごう	mã Pin, mật khẩu
身分証明書	みぶんしょうめいしょ	chứng minh thư
健康保険証	けんこうほけんしょう	thẻ BHYT
症状	しょうじょう	triệu chứng
熱中症	ねっちゅうしょう	say nắng, kiệt sức vì nhiệt
炎症	えんしょう	viêm, sưng tấy
後遺症	こういしょう	di chứng, hậu quả sau khi bệnh
整う	ととのう	được chuẩn bị, sắp xếp
整える	ととのえる	chuẩn bị, sắp xếp điều chỉnh
整備	せいび	bảo dưỡng, sửa chữa
調整	ちょうせい	điều chỉnh, điều hòa
福祉	ふくし	phúc lợi
肯定	こうてい	khẳng định
肯定的	こうていてき	quả quyết, khẳng định
渋い	しぶい	vị chát, đắng, khó chịu, cau có
渋滞	じゅうたい	tắc nghẽn, ùn tắc
万歳	ばんざい	vạn tuế, sống lâu
盛ん	さかん	thời hoàng kim, thịnh hành
繁盛	はんじょう	phồn thịnh, phát đạt
育ち盛り	そだちざかり	giai đoạn phát triển, độ tuổi đang lớn
食べ盛り	たべざかり	thời kỳ ăn nhiều
働き盛り	はたらきざかり	đỉnh cao sự nghiệp, thời kì độ tuổi lao động chính
盛り上がる	もりあがる	tăng lên, sôi động
城	しろ	lâu đài, thành
武器	ぶき	vũ khí
武士	ぶし	võ sĩ, chiến binh
地域	ちいき	khu vực, vùng
裁判	さいばん	phiên tòa, xét xử
裁判所	さいばんしょ	tòa án
我々	われわれ	chúng tôi, chúng ta
我慢	がまん	chịu đựng, nhẫn lại
我慢強い	がまんづよい	chịu đựng giỏi, kiên nhẫn
意義	いぎ	ý nghĩa, ý tứ
義務	ぎむ	nghĩa vụ, bổn phận
主義	しゅぎ	chủ nghĩa
講義	こうぎ	bài giảng, buổi giảng dạy
お辞儀	おじぎ	cúi chào, chào hỏi
儀式	ぎしき	nghi lễ, lễ nghi
礼儀	れいぎ	lễ phép, phép tắc
詳しい	くわしい	chi tiết, tường tận
詳細	しょうさい	chi tiết, tỉ mỉ
群れ	むれ	đàn, bầy, nhóm
鮮やか	あざやか	rực rỡ, sáng sủa
新鮮	しんせん	tươi, tươi mới, mới mẻ
善良	ぜんりょう	lương thiện, tốt bụng
仲良い	なかよい	mối quan hệ tốt, thân thiết
仲良し	なかよし	bạn bè thân thiết, người bạn tốt
仲直り	なかなおり	hòa giải, làm lành
仲間	なかま	bạn bè, đồng độ
串焼き	くしやき	xiên nướng
患者	かんじゃ	bệnh nhân
金融	きんゆう	tài chính
騒ぐ	さわぐ	làm ồn, làm ầm ĩ
大騒ぎ	おおさわぎ	ồn ào, ầm ĩ
騒々しい	そうぞうしい	ồn ào, ầm ĩ
騒音	そうおん	tiếng ồn
嵐	あらし	bão, giông tố
触る	さわる	chạm vào, sờ
触れる	ふれる	chạm vào, tiếp xúc, đề cập
布	ぬの	vải
座布団	ざぶとん	chiếu, đệm ngồi
配布	はいふ	phân phát
分布	ぶんぷ	phân bố
怖い	こわい	sợ, đáng sợ
怖がる	こわがる	sợ hãi, hoàng sợ
恐怖	きょうふ	nỗi sợ, sự kinh hoàng
希望	きぼう	hy vọng, mong muốn
希望者	きぼうしゃ	người mong muốn, ứng viên
手帳	てちょう	sổ tay, cuốn sổ
通帳	つうちょう	sổ tài khoản ngân hàng
帽子	ぼうし	mũ, nón
帯	おび	dải, đai, đai lưng
地帯	ちたい	vùng, khu vực
熱帯	ねったい	vùng nhiệt đới
包帯	ほうたい	băng vết thương
衣服	いふく	quần áo
衣装	いしょう	trang phục, y phục
衣料品	いりょうひん	sản phẩm may mặc
浴衣	ゆかた	yukata, áo kimono mùa
依頼	いらい	yêu cầu, nhờ vả
補う	おぎなう	bổ sung, đền bù
候補	こうほ	dự khuyết, ứng cử
補助	ほじょ	hỗ trợ, trợ cấp
補正	ほせい	sửa chữa, điều chỉnh
壊す	こわす	làm hỏng, phá vỡ
壊れる	こわれる	bị hỏng, bị vỡ
服装	ふくそう	trang phục, cách ăn mặc
いしょう	い しょう	y phục, trang phục
包装	ほうそう	bao bì, sự đóng gói
装置	そうち	thiết bị, dụng cụ
袋	ふくろ	túi, bao
手袋	て ぶくろ	găng tay
紙袋	かみぶくろ	túi giấy
製作	せいさく	sản xuất, chế tạo
製造	せいぞう	sản xuất, chế tạo
木製	もくせい	làm bằng gỗ
先祖	せんぞ	tổ tiên
祖父	そふ	Ông
祖母	そぼ	Bà
祈る	いのる	cầu nguyện
祝う	いわう	chúc mừng, kỷ niệm
お祝い	おいわい	lễ kỷ niệm, quà chúc mừng
祝日	しゅくじつ	ngày lễ
返却	へんきゃく	trả lại, hoàn trả
即座	そくざ	ngay lập tức, tức thì
節約	せつやく	tiết kiệm
調節	ちょうせつ	điều chỉnh, điều tiết
切符	きっぷ	vé
筆者	ひっしゃ	tác giả, người viết
筆記	ひっき	viết, ghi chép
築く	きずく	xây dựng, tạo dựng
建築	けんちく	kiến trúc, xây dựng
管理	かんり	quản lý
管理下	かんりか	dưới sự quản lý
封筒	ふうとう	bao thư, phong bì
対策	たいさく	biện pháp, đối sách
簡単	かんたん	đơn giản, dễ dàng
簡略	かんりゃく	rút gọn, đơn giản hóa
在籍	ざいせき	đang ghi danh, hiện có trong danh sách
書籍	しょせき	sách vở, tài liệu
国籍	こくせき	quốc tịch
多国籍	たこくせき	đa quốc tịch
範囲	はんい	phạm vi, khu vực
模範	もはん	hình mẫu, gương mẫu
犯す	おかす	phạm, vi phạm
犯罪	はんざい	tội phạm, tội ác
犯人	はんにん	kẻ phạm tội, thủ phạm
猫	ねこ	con mèo
狭い	せま	hẹp, chật
中央	ちゅうおう	trung tâm, trung ương
現状	げんじょう	tình hình hiện tại
状況	状況	tình hình, hoàn cảnh
状態	じょうたい	trạng thái, tình trạng
案内状	あんないじょう	thư mời, thư hướng dẫn
クリーム状	クリームじょう	dạng kem, dạng như kem
寄せる	よせる	gửi; tập trung lại; đến gần; dựa vào
押し寄せる	おしよせる	dâng lên
立ち寄る	たちよる	ghé qua
近寄る	ちかよる	tiến gần, đến gần
もちよる	もちよる	mang đến, mang theo để tụ lại
年寄り	としより	người già
寄付	きふ	tặng, đóng góp
~冊	さつ	đơn vị đếm sách
再び	ふたたび	một lần nữa, lại
再会	さいかい	tái ngộ, gặp lại
再開	さいかい	mở lại, bắt đầu lại
再提出	さいていしゅつ	nộp lại, gửi lại
古典	こてん	cổ điển, tác phẩm cổ điển
典型的	てんけいてき	đặc trưng, điển hình
豊か	ゆたか	phong phú, giàu có
農家	のうか	nông dân
農業	のうぎょう	nông nghiệp
農作物	のうさくぶつ	sản phẩm nông nghiệp, nông sản
農薬	のうやく	thuốc trừ sâu
濃い	こい	đậm, đặc
濃度	のうど	nồng độ
濃厚	のうこう	đậm đà, đậm đặc
振舞う	ふりまう	cư xử, hành xử
身振り	みぶり	cử chỉ, điệu bộ
振り返る	ふりかえる	nhìn lại, quay đầu lại
振り込む	ふりこむ	chuyển khoản
震える	ふるえる	run rẩy, rung động
地震	じしん	động đất
大臣	だいじん	bộ trưởng
副大臣	ふくだいじん	phó bộ trưởng, thứ trưởng
冷蔵庫	れいぞうこ	tủ lạnh
貯蔵	ちょぞう	lưu trữ, bảo quản
心臓	しんぞう	tim
堅実	けんじつ	vững chắc, chắc chắn; thiết thực
緊張	きんちょう	căng thẳng, lo lắng
緊張感	きんちょうかん	cảm giác căng thẳng
賢い	かしこい	thông minh, sáng suốt
賢明	けんめい	khôn ngoan, sáng suốt
掃く	はく	quét, lau
清掃	せいそう	vệ sinh, dọn dẹp
大掃除	おおそうじ	tổng vệ sinh
侵す	おかす	xâm phạm, xâm lấn
侵入	しんにゅう	xâm nhập
寝る	ねる	ngủ
寝付きが悪い	ねつきがわるい	khó ngủ
寝不足	ねぶそく	thiếu ngủ
寝際	ねぎわ	lúc sắp ngủ, lúc chợp mắt
寝室	しんしつ	phòng ngủ
販売	はんばい	bán hàng, việc bán
財布	さいふ	ví tiền
財産	ざいさん	tài sản
片方	かたほう	một bên, một phía
出版	しゅっぱん	xuất bản
英語版	えいごばん	phiên bản tiếng Anh
限定版	げんていばん	phiên bản giới hạn
看病	かんびょう	chăm sóc bệnh nhân
看板	かんばん	biển hiệu
省く	はぶく	loại bỏ, cắt bỏ
省略	しょうりゃく	rút gọn, lược bỏ
反省	はんせい	tự kiểm điểm, phản tỉnh
帰省	きせい	về quê, về thăm nhà
眼科	がんか	khoa mắt
眼鏡/眼鏡	めがね/がんきょう	kính mắt
限る	かぎる	giới hạn, hạn chế
限度	げんど	giới hạn, mức độ
制限	せいげん	hạn chế
期限	きげん	Thời hạn
期限切	きげんきり	hết hạn
無限	むげん	vô hạn
検定版	けんていばん	phiên bản giới hạn
防ぐ	ふせぐ	ngăn ngừa, phòng tránh
防止	ぼうし	ngăn chặn, phòng chống
防犯	ぼうはん	phòng chống tội phạm
消防署	しょうぼうしょ	trạm cứu hỏa
消防団	しょうぼうだん	đội cứu hỏa tình nguyện
隅	すみ	góc, xó
隅々	すみずみ	từng ngóc nghách, khắp mọi nơi
除く	のぞく	loại bỏ, loại trừ
削除	さくじょ	xóa bỏ, loại bỏ
掃除	そうじ	dọn dẹp, vệ sinh
掃除機	そうじき	máy hút bụi
隠す	かくす	giấu, che giấu
隠れる	かくれる	ẩn nấp, trốn
隣	となり	hàng xóm, bên cạnh
迷信	めいしん	mê tín
迷路	めいろ	mê cung, mê lộ
迷惑行為	めいわくこうい	hành vi gây phiền phức
述べる	のべる	trình bày, diễn tả, nói ra
途方	とほう	cách thức, phương pháp
用途	ようと	công dụng, mục đích sử dụng
途中	とちゅう	giữa chừng, dọc đường
途端	とたん	ngay khi, vừa mới
造る	つくる	làm, tạo ra
改造	かいぞう	cải tạo, sửa đổi
構造	こうぞう	cấu trúc, kết cấu
創造	そうぞう	sáng tạo
伸びる	のびる	kéo dài, giãn ra, được kéo dài
伸ばす	のばす	kéo dài, làm cho dài ra, trì hoãn
延期	えんき	hoãn, trì hoãn
遅延	ちえん	trì hoãn, chậm trễ
誕生日	たんじょうび	sinh nhật
絞る	しぼる	vắt, siết chặt; tập trung
比較	ひかく	so sánh
効く	きく	có tác dụng, có hiệu quả
効果	こうか	hiệu quả
効果的	こうかてき	có hiệu quả, hiệu quả
逆効果	ぎゃくこうか	hiệu quả ngược lại, phản tác dụng
構う	かまう	quan tâm, để ý, chăm sóc
構成	こうせい	cấu thành, cấu tạo
購入	こうにゅう	mua, sắm, mua sắm
休講	きゅうこう	nghỉ học, hủy buổi học
講演	こうえん	bài giảng, thuyết trình
講座	こうざ	khoa học, lớp học
軒	のき	mái hiên
金庫	きんこ	két sắt
倉庫	そうこ	kho, nhà kho
軍隊	ぐんたい	quân đội
後輩	こうはい	hậu bối, đàn em, người vào sau
船	ふね	thuyền
欠航	けっこう	hủy chuyến bay
航空	こうくう	hàng không
飾り	かざり	đồ trang trí
飾る	かざる	trang trí
飼う	かう	nuôi (động vật)
飼い主	かいぬし	chủ nuôi
教養	きょうよう	có nền tảng giáo dục, có học thức
要請	ようせい	đào tạo, bồi dưỡng
導く	みちびく	dẫn dắt, chỉ đạo
指導	しどう	hướng dẫn, chỉ đạo
注射	ちゅうしゃ	tiêm, chích
発射	はっしゃ	phóng, bắn
謝る	あやまる	xin lỗi, tạ lỗi
感謝	かんしゃ	biết ơn, cảm ơn
鉱物	こうぶつ	khoáng vật, khoáng sản
針	はり	cái kim
銅メダル	どうめだる	huy chương đồng
鈍い	にぶい	cùn, chậm, lờ đờ
鈍感	どんかん	vô cảm, thiếu nhạy cảm
革製	かわせい	làm bằng da
靴	くつ	giày
靴下	くつした	vớ, tất
抱く	だく	ôm, ôm ấp
抱える	かかえる	mang, vác, chịu đựng
泡	あわ	bọt, bong bóng
巻く	まく	quấn, cuộn
巻き込む	まきこむ	cuốn vào, liên lụy
庭	にわ	vườn
庭園	ていえん	khu vườn
家庭	かてい	gia đình, hộ gia đình
家庭用	かていよう	dùng trong gia đình
奥底	おくそこ	nơi sâu thẳm, tận đáy
底	そこ	đáy
到底	とうてい	hoàn toàn ( không thể )
気象庁	きしょうちょう	cục khí tượng
疲労	ひろう	mệt mỏi, kiệt sức
労働	ろうどう	lao động
苦労	くろう	gian khổ, vất vả
劣る	おとる	kém hơn, thua kém
勇ましい	いさましい	dũng cảm, mạnh mẽ
勇気	ゆうき	dũng khí, can đảm
大勢	おおぜい	nhiều người, đám đông
勢い	いきおい	sức mạnh, đà, xu thế
易い	やすい	dễ ( làm gì đó )
安易	あんい	đơn giản, dễ dãi
お湯	おゆ	nước nóng
湯気	ゆげ	hơi nước
傷	きず	vết thương, trày xước
傷む	いたむ	bị hỏng, bị tổn thương
傷つく	きずつく	bị tổn thương ( tinh thần, danh dự )
火傷	やけど	bỏng
軽傷	けいしょう	vết thương nhẹ
酔う	よう	say ( rượu, tàu xe, v.v..)
酔っ払う	よっぱらう	say rượu
二日酔い	ふつかよい	dư âm say rượu, bị say hôm sau
酢	す	dấm
瓦	かわら	ngói
瓶	びん	chai, lọ
花瓶	かびん	bình hoa
終了	しゅうりょう	kết thúc, hoàn thành
完了	かんりょう	hoàn tất
了解	りょうかい	hiểu rõ, đồng ý
承る	うけたまわる	tiếp, lắng nghe (khiêm nhường ngữ của 聞く／受ける)
伝承	でんしょう	truyền thừa, truyền miệng
承知	しょうち	biết rõ, hiểu rõ
承認	しょうにん	chấp thuận, phê
矛盾	むじゅん	mâu thuẫn
務め	つとめ	nhiệm vụ, công việc / chức vụ
勤務	きんむ	công việc, làm việc
業務	ぎょうむ	công việc, nghiệp vụ
実務	じつむ	công việc thực tế
税務署	ぜいむしょ	cục thuế
柔らかい	やわらかい	mềm mại
柔道	じゅうどう	Nhu đạo (Judo)
批判	ひはん	phê phán
批判的	ひはんてき	mang tính chỉ trích
段階	だんかい	giai đoạn
段階的	だんかいてき	theo từng bước
現段階	げんだんかい	giai đoạn hiện tại
混ざる	まざる	trộn lẫn
混ぜる	まぜる	trộn, pha
かき混ぜる	かきまぜる	khuấy đều
混雑	こんざつ	đông đúc, tắc nghẽn
珍しい	めずらしい	hiếm, lạ
診る	みる	khám bệnh
診察	しんさつ	khám bệnh
受診	じゅしん	đi khám
検診	けんしん	kiểm tra sức khỏe
診断	しんだん	chẩn đoán
健康診断	けんこうしんだん	khám sức khỏe định kỳ
参考	さんこう	tham khảo
参観	さんかん	tham quan, dự giờ
持参	じさん	mang theo
参加賞	さんかしょう	phần thưởng tham gia
修理	しゅうり	sửa chữa
修正	しゅうせい	chỉnh sửa
研修生	けんしゅうせい	thực tập sinh
修理代	しゅうりだい	phí sửa chữa
州	しゅう	bang, tỉnh
永久	えいきゅう	sự vĩnh cửu; sự mãi mãi; cái vĩnh cửu
永遠に	えいえんに	mãi mãi
半永久	はんえいきゅう	gần như vĩnh cửu
救う	すくう	cứu giúp
救助	きゅうじょ	cứu hộ
救急車	きゅうきゅうしゃ	xe cấp cứu
甘い	あまい	ngọt, non nớt
甘える	あまえる	làm nũng, dựa dẫm
戸	と	cửa, cánh cửa
一戸建て	いっこだて	nhà riêng, nhà độc lập
お互い	おたがい	cùng nhau
相互	そうご	lẫn nhau, tương hỗ
民族	みんぞく	dân tộc
乏しい	とぼしい	nghèo nàn, thiếu thốn
卵	たまご	quả trứng
塾	じゅく	lớp học thêm, trung tâm học thêm
名刺	めいし	danh thiếp