初歩:しょほ: cơ bản, cơ sở (khóa học, học hành,...) = 基礎 - きそ
初期: しょき: thời kì đầu (thời gian)
最寄り: もより: gần nhất (địa điểm)
確保: かくほ: đảm bảo (an toàn, học tập,...)
引退: いんたい: giải nghệ, rút lui (dành cho cầu thủ, nghệ sĩ,...)
注目 = 感心: chú ý, quan tâm (tới việc)
用途: ようと: công dụng (của đồ vật)
本来: ほんらい: vốn dĩ (ban đầu)
敏感: びんかん:  mẫn cảm (với thông tin, dị ứng)
保存: ほぞん: lưu, bảo quản (file, đồ ăn)
油断: ゆだん: cẩu thả, lơ đểnh, mất cảnh giác (với ng 2 mặt)
裏切る: うらぎる: phản bội
分担: ぶんたん: phân chia (công việc)
役目: やくめ: vai trò (không rõ ràng, vai trò chung chung)
役割: やくわり: vai trò (cụ thể, công việc rõ ràng)
同感: 同感: đồng tình (với việc nào đó)
同情: どうじょう: đồng cảm (cảm xúc)
転勤: てんきん: chuyển công tác
栽培: さいばい: trồng (cây, thực vật)
思わぬ: おもわぬ: không ngờ tới (ぬ = ない)
かかりつけ: riêng (cá nhân, bác sĩ riêng, bệnh viện riêng hay lui tới)
素材: そざい: nguyên vật liệu (hương vật liệu vốn có, thực phẩm)
充満: じゅうまん: tràn đầy (khói, mùi,...)
信頼: しんらい: tin cậy (chỉ cảm tính)
信用: しんよう: tin cậy (có cơ sở tin tưởng, tín dụng ngân hàng)
尊重: そんちょう: tôn trọng (ý kiến, công việc, thứ có giá trị)
尊敬: そんけい: tôn kính (với người trên)
欠陥: けっかん: lỗi, thiếu sót (của sản phẩm)
評価: ひょうか: đánh giá (が高い、が低い、をつける)
評判: ひょうばん: đánh giá (が良い、が悪い)
批判: ひはん chỉ trích, phê phán (phủ định, phê phán, phạm vi sử dụng rộng)
非難:ひなん: chỉ trích (con người, xã hội)
批評: ひひょう nhà phê bình (批評家)
増大: ぞうだい: tăng lên (với quy mô rất lớn, tăng về cảm giác)
増加: ぞうか: tăng (quy mô ít hay nhiều đều được, có thể đếm được)
上昇: じょうしょう: tăng lên (giá, khí, nhiệt độ, máy bay)
上達: じょうたつ: tiến bộ (chỉ trong học tập)
進歩: しんぽ: tiến bộ (trong nhiều mục đích chung, khoa học, xã hội,...)
進捗: しんちょく: tiến độ công việc
削除: さくじょ: xóa (file, dữ liệu)
整備: せいび: bảo dưỡng (phương tiện di chuyển lớn)
点検: てんけん: kiểm tra (phạm vi rộng, xe, thang máy, tòa nhà,...)
視線: しせん: ánh nhìn (を浴びる thu hút ánh nhìn)
才能: さいのう: tài năng (才能が豊かだ)
効用: こうよう: hiệu dụng (công dụng thuốc)
効力: こうりょく: hiệu lực (dùng trong hợp đồng, giấy phép,...)
改造: かいぞう: cải tạo, tân trang (nhà, xe)
転換: てんかん: chuyển đổi (気分転換 - chuyển đổi tâm trạng, 方向転換 - chuyển làn xe)
展開: てんかい: diễn biến (phim ảnh, manga,...), triển khai, mở rộng (thị trường)
見た目: みため: vẻ ngoài (thường dùng cho đồ ăn)
格好: かっこう: vẻ ngoài (cách ăn mặc)
容姿: ようし: vẻ ngoài, phong thái (cách ăn mặc bên ngoài, có thể dùng với đồ vật, nhấn mạnh về khuôn mặt thường dùng cho nữ)
様子: ようす: bộ dạng (phạm vi rộng, có thể dùng cho trạng thái con người, thời tiết)
姿: すがた: bóng người (có bóng người, nói về sự tồn tại của 1 ng, diện mạo bên ngoài)
普及: ふきゅう: phổ cập (1 sản phẩm, dịch vụ phổ biến)
いらいら: hơi bực mình
ぎっしり: vừa khít, làm chặt (thường đi với つまり)
こっそり: lén lún, làm gì đó lén lút
でこぼこ: lồi lõm (đường)
はきはき: rõ ràng, mạch lạc (=生き生き)
さっさと: khẩn trương, nhanh chóng
にこにこ: cười mỉm (=にこり đọc nghe như にっこり)
すっきり: đơn giản, thoái mái, rõ ràng (cảm giác vừa tắm xong ra, bài văn dễ hiểu)
くっきり: cực kì rõ
ざっと: (làm 1 việc) lướt nhanh, xem sơ qua
いきいき: hăng hái, hoạt bác
ふわふわ: mềm mại (ふかふか: ôm gối, chăn, gấu)
取材:しゅざい: phỏng vấn (phóng viên lấy tin)
範囲: はんい: phạm vi (phạm vi rộng)
体格: たいかく: vóc dáng (rắn chắc, thường đi với がっしり - rắn chắc)
外見: がいけん: nhấn mạnh về vẻ bên ngoài (nghịch với bên trong của con người)
合図: あいず: tín hiệu (ra hiệu, ra dấu, hành động của con người, thường liên quan đến thể thao)
注目: chú ý (1 việc gì đó thu hút sự chú ý của dư luận, thường là thể bị động) 注目を浴びる、集める
吸収: hấp thu (dinh dưỡng, nước), hấp thu (kinh nghiệm, bí quyết)
性能: せいのう: tính năng (hiệu suất, chất lượng hoạt động 高性能 - hiệu suất cao)
機能: きのう: chức năng (chức năng máy móc)
予想: よそう: dự đoán (dựa trên suy nghĩ)
予報: よほう: dự báo (dựa vào dữ liệu, phân tích)
対比: たいひ: so sánh (sự đối lập, tương phản)
比較: ひかく: so sánh (của 2 hoặc nhiều vật thể)
比べる: くらべる: so sánh (dùng trong tất cả trường hợp)
伝染: でんせん: truyền nhiễm, lây truyền (bệnh tật, tính cách)
選出: せんしゅつ: chọn ra (sát hạch kĩ lưỡng)
先端: せんたん: tiên tiến, mũi nhọn (công nghệ, trào lưu)
中途半端: ちゅうとはんぱ:  nửa vời, làm lưng chừng, hiểu nửa vời
専属: せんぞく: độc quyền (chuyên ngành)
孤立: こりつ: cô lập
区分: くぶん: phân chia (lãnh thổ, khu vực)
分割: ぶんわり: phân chia (bị chia theo ranh giới)
移行: いこう: di chuyển (file, data, content,...)
移住: いじゅう: di cư
養成:ようせい: đào tạo (thường dùng trong công việc)
育成:いくせい: chăm sóc (nuôi dưỡng con người)
考慮: こうりょ: xem xét, suy tính (sự tình, vấn đề, cân nhắc dựa trên nhiều yếu tố)
検討: けんとう: xem xét (cân nhắc để ra quyết định)
提案: ていあん: đề án, đề xuất, gợi ý
定着: ていちゃく: định hình, ổn định vững chắc (1 điều mới trở thành điều hiển nhiên)
判断: はんだん: phán đoán, đánh giá
凸凹:でこぼこ: lồi lỏm (văn nói) 
凹凸: おうとつ: lồi lõm (văn viết)
指摘:してき: chỉ ra (vấn đề, lỗi sai)
決勝戦: けっしょうせん: chung kết
準決勝:じゅんけっしょう:  bán kết
準々決勝: じゅんじゅんけっしょう: tứ kết
活気: かっき: náo nhiệt (dùng cho thành phố, đất nước)
活発: かっぱつ: náo nhiệt, sôi nổi (Dùng cho người)
放映: ほうえい: phát sóng
中継: ちゅうけい: thường là phát sóng trực tiếp
採用: さいよう: tuyển dụng (người, ý kiến)
雇用: こよう: tuyển dụng (chỉ đi với người)
進出: しんしゅつ: tiến lên, vươn ra (dùng cho doanh nghiệp, tiến ra quốc tế)
拡大:かくだい: zoom in, phóng to, khuếch đại
縮小: しゅくしょ: zoom out (không thay đổi diện tích)
拡張: かくちょう: mở rộng (có thay đổi diện tích)
需要: じゅよう: nhu cầu
投票: とうひょう: bỏ phiếu
選挙: せんきょ: bầu cử
区切り: くぎり: phân chia (chia theo mốc dấu chấm, dấu phẩy, hiệp đấu)
保障:ほしょう: bảo đảm (bảo chứng khi xảy ra thương tật, thương vong, đảm bảo quyền lợi con người)
保証: ほしょう: bảo hành
補償: ほしょう: bồi thường
恐れ入る:おそれいる: xin lỗi (dùng trong doanh nghiệp, kính ngữ) = すみません
折り返し: おりかえす: gọi lại sau, quay trở lại = あとで
前後: ぜんご: trước sau
お手元: おてもと: có sẵn trên tay = 持っている
ご覧ください: xem
後日: ごじつ: ngày sau
改めて: あらためて: cải thiện lại, làm lại  = もう一度
早々: そうそう: làm nhanh = すぐ
まこと: thành thật = 本当
その件は: sự việc đó = それについて
おいでになります: đến = きま
承ります:うけたまわります:  khiêm nhường của 受ける
素直な:すなおな: người thật thà
行為: こうい: hành vi, hành động
たっぷり: đầy đủ (=十分)
省略: しょうりゃく: giản lược
収納: しゅうのう: cất (vào kho = しまう)
導入: どうにゅう: đưa vào (sử dụng), dẫn nhập
油断: ゆだん: cẩu thả, lơ là (xem thường đối thủ)
納得: なっとく: hiểu rõ (vấn đề)
分配: ぶんぱい: phân chia (lợi ích)
状況: じょうきょう: tình hình, bối cảnh (công việc, 1 việc chung)
役割: やくわり: vai trò (phân chia cụ thể công việc, ai làm cái gì)
役目: やくめ: vai trò (bổn phận của người mẹ, sếp)
カルチャーショック: sốc văn hóa
異なる: いなる: khác biệt
いたずら: nghịch ngợm (chỉ dùng cho con nít)
対等: たいとう: tương dương, ngang bằng (không có sự khác biệt)
平等: びょうどう: bình đẵng (con người đều bình đẵng, giới tính)
公平: こうへい: công bằng ai cũng như ai
平均: へいきん: trung bình
改訂: かいてい: cải chính, sửa đổi (sách, pháp luật)
改革:かいかく: cải cách
殺す: ころす: giết (殺される - bị giết)
批判: ひはん: phê bình (cả tích cực và tiêu cực)
共同: きょうどう: sự hợp tác chung, đồ chung (bếp chung, nhà chung)
共有: きょうゆう: chia sẻ (cho mng, thông tin cho mng biết)
共通: きょうつう: dùng chung, làm chung (giống 同じ) = 共同
予想: よそう: dự đoán (dựa vào suy nghĩ)
予測: よそく: dự đoán (dựa vào dữ liệu)
招く: まねく: mời gọi
誤解を招く: ごかいをまねく: gây ra sự hiểu lầm (nghĩa tiêu cực)
天気: てんき: thời tiết (ngay thời điểm nói, ngày nói)
天候: てんこう: thời tiết (tuần, tháng)
気候: きこう: khí hậu (mùa)
仕組み: しくみ: cấu tạo, cơ chế (của máy móc, cơ thể, doanh nghiệp)
一変: いっぺん: thay đổi (hoàn toàn) = すっかり(完全に)変わること
呑気: のんき: vô tư, vô lo (nghĩa tiêu cực, chê trách)
倹約: けんやく: tiết kiệm tiền (= 節約 - せつやく)
拒む: こばむ từ chối (= 断る - ことわる = 拒否 - きょひ)
貿易: ぼうえき giao thương, mậu dịch
防犯: ぼうはん: chống tội phạm
防火: ぼうか chống cháy
装置: そうち thiết bị (nói đến 1 vật cụ thể, máy báo cháy, vật đơn lẻ)
医療機関: いりょうきかん: cơ quan y tế
方針: ほうしん: phương châm (cơ quan, đoàn thể, tổ chức, công ty, đất nước)
行事: ぎょうじ: sự kiện (được tổ chức hàng năm)
イベント: sự kiện (không tổ chức thường niên)
設備: せつび: trang bị, cơ sở (cả hệ thống)
建設: けんせつ: xây dựng, kiến thiết
印刷: いんさつ: in ấn (=プリント) in theo set thì 1分,  2分
貨物: かもつ: hàng hóa (trong logistic)
延長: えんちょう: kéo dài (đã bắt đầu rồi bị kéo dài ra)
延期: えんき: trì hoãn (trước khi bắt đầu)
機嫌: きげん: tâm trạng (thường đi với ご機嫌, 機嫌が良い, 機嫌が悪い)
規制: きせい: quy định (phạm vi lớn, xã hội, địa phương, trong pháp luật)
規則: きそく: quy tắc (trong công ty, tổ chức =ルール)
皮膚: ひふ: da (dùng cho văn cứng)
熱演: ねつえん: diễn xuất nhập tâm
構造: こうぞう: cấu tạo của cty, của cơ thể (組織 - そしき - cấu trúc cty, 仕組み - cấu trúc của team)
構築: こうちくcấu trúc, xây dựng (của hệ thống, build)
就職: しゅうしょく: tìm việc
警備: けいび: cảnh vệ (警備員)
賃貸: ちんたい: cho thuê (=レンタル)
差別: さべつ: phân biệt đối xử (phân biệt chủng tộc)
ライバル: (công ty) đối thủ
標準: ひょうじゅん: tiêu chuẩn
豊かな:ゆたか: phong phú (=豊富-ほうふ)
未熟: みじゅく non, xanh, chưa chín, kiến thức còn chưa thành thạo
壁を超える:かべをこえる: vượt rào cản
感覚: かんかく: cảm giác = 気分
余裕: よゆう: dư, thong thả (thời gian, tiền bạc)
低下: suy giảm <> 向上: tăng lên
見事: みごと: vẻ đẹp, điêu luyện, thời tiết đẹp (trong lời khen, tán dương = 上手に)
休養: きゅうよう: nghỉ ngơi dưỡng bệnh
処分: しょぶん: xử lý (rác), xử phạt
設定: せってい: cài đặt/ thiết lập phần mềm, thiết bị, mục tiêu
設置: せっち: lắp đặt (gia dụng, vật dụng)
後日改めて: ごじつあらためて: ngày hôm sau sẽ làm lại 1 lần nữa (gọi lại)
作業: さぎょう: công việc (tay chân)
天然:てんねん: thiên nhiên
人工:じんこう: nhân tạo
人工知能: じんこうちのう: trí tuệ nhân tạo
重視:じゅうし: xem trọng
軽視: けいし: xem nhẹ
対立: たいりつ: đối lập
巡る: めぐる: xoay quanh (vấn đề)
つい: bất chợt (=思わず)
熱中: ねっちゅう: say mê (tích cực)
夢中:むちゅう: say mê (hơi tiêu cực, nghiện)
熱中症: ねっちゅうしょう: bệnh say nắng
災い: わざわい: họa
真夜中: まよなか nửa đêm
実施: じっし: triển khai (sự kiện, hành động của tổ chức theo kế hoạc đặt sẵn) 
実行: じっこう: thực hiện (hành động của cá nhân)
著者:ちょしゃ: tác giả, nhà văn (=筆者)
作家: さっか: nhà văn chuyên nghiệp
患者: かんじゃ bệnh nhân
批評家: ひひょうか: nhà phê bình
出世: しゅっせ: thăng tiến
開設: かいせつ: mở (tài khoản ngân hàng 銀行口座を開設する)
製造: せいぞう: chế tạo (máy móc lớn, xe, máy bay,...)
制作: せいさく: chế tác(vật nhỏ, bu lông, ốc vít, đồ gỗ)
思い込み: おもいこみ: lầm tưởng, định kiến
能率: のうりつ: năng suất (công việc)
反抗期: はんこうき: tuổi nổi loạn
無駄遣い: むだづかい: sử dụng lãng phí
休暇: きゅうか: ngày nghỉ có phép (trong công ty)
を+眺める: ながめる: ngắm nhìn
眺めがいい: ながめがいい: cảnh đẹp
感心する: かんしんする:  ngưỡng mộ (cảm động)
あこがれ: ngưỡng mộ (ao ước)
関心する: 関心する: quan tâm
発揮: はっき: phát huy (= 活かす)
尽きる: つきる: cạn kiệt (力が尽きる - cạn kiệt sức lực, 話が尽きない - nói không hết chuyện)
相次ぐ: あいつぐ: nối tiếp, tiếp tục xảy ra
倒産: とうさん: phá sản
を+保つ: たもつ: bảo vệ, duy trì
終日: しゅうじつ = 一日中: suốt cả ngày
忠実: ちゅうじつ: trung thực
偉大: いだい: vĩ đại
偉い: えらい siêu (dùng trong lời khen)
解消: かいしょう: giải quyết (stress, vấn đề trong công việc)
解除: かいじょ: mở khóa
声明: せいめい công bố (声明を発表)
進行: しんこう: tiến độ (trung lập, có thể tích cực và tiêu cực)
空室: くうしつ: phòng trống
うつむく: cúi mặt xuống (xấu hổ =下へ向いて)
うなずく: gật đầu (đồng ý)
躓く: つまずく: vấp ngã
つぶす: đập dẹp, phá sản, giết thời gian
生じる:しょうじる: phát sinh (điều tiêu cực, lỗi, vấn đề) = 発生する
構う: かまう: để tâm, quan tâm tới
潜る:もぐる: lặn xuống, chùm trong chăn
至る:いたる: đạt được, cho đến (thời điểm hiện tại)
省く:はぶく:  lược bớt (thời gian, công sức)
捉える:とらえる: nắm bắt (cơ hội)
捕らえる:とらえる: bắt (người, trộm, hữu hình)
訪ねる:たずねる: thăm (người)
訪れる:おとずれる: thăm (người, địa điểm)
訪問する: ほうもんする: chuyến thăm (của lãnh đạo)
生かす: いかす: phát huy, tận dụng, hồi sinh
扱う: あつかう: thao tác (với đồ vật), xử lý, bán (đồ), đối phó, giải quyết
就く: つく: nhậm (chức vụ, vị trí)
恵まれる:めぐまれる: được ban cho, độ cho (thần ban cho)
大したものですね: lời khen (ngưỡng mộ = お見事ですね = 素晴らしいですね)
いじる: chạm, nghịch
協調性: tính đồng thuận (nghe theo số đông)
揃う: そろう: tập trung, làm cho đồng nhất
抱える: かかえる: ôm (vấn đề, công việc, vật)
導く:みちびく: hướng dẫn, chỉ đạo
努める: つとめる: nỗ lực
勤める: つとめる: làm việc (tại cty)
務める: つとめる: đảm đương (nhiệm vụ cụ thể)
演じる:えんじる: diễn, giả vờ
ふりをする: giả vờ
けなす: chế giểu, mỉa mai
築く:きずく: xây dựng (tổ ấm, cơ ngơi, mối quan hệ, niềm tin, nghĩa bóng)
依頼すみ:いらいすみ:đã nhờ vả (ng khác) xong
報じる: ほうじる: thông báo (qua đài phát thanh)
済ます: すます: hoàn tất (công việc, ngữ pháp)
~で済む: làm ... cũng xong
怠け者:なまけもの: ng làm biếng, con lười
貢献する:こうけんする: cống hiến
備える:そなえる: chuẩn bị (cho tương lai, cho thiên tai)
諦める: あきらめる: từ bỏ (điều muốn làm nhưng từ bỏ)
辞める:やめる: từ bỏ (cả việc muốn và không muốn)
あきれる: ngạc nhiên (có sự thất vọng)
驚く: おどろく: ngạc nhiên (nói về sự bất ngờ)
寛ぐ:くつろぐ: nghỉ ngơi, thư giản
与える: あたえる: cho, cấp (đồ ăn, học bổng)
実る: みのる: đơm hoa kết trái, tạo ra thành quả, đạt kết quả
補う: おぎなう: bổ sung, đền bù
捕捉: ほそく: bổ sung cho thuyết minh
補充: ほじゅう: bổ sung nhân viên, mực in, giấy in
控える:ひかえる: kiềm chế, hạn chế (hút thuốc, uống rượu), đứng ở phía sau (người, sân khấu), chuẩn bị, sắp (lễ, sự kiện)
雇う:やとう: tuyển dụng
儲ける:もうける:kiếm lời, có con
怪しい:あやしい: đáng ngờ
...とは限らない: không hẵn (phủ định 1 phần)
改める: あらためる: làm lại, sửa đổi, cải thiện (hôm sau tôi sẽ trao đổi lại)
触れる:ふれる: chạm (thứ trừu tượng, văn hóa, sự việc)
触る:さわる: chạm vật
破れる: やぶれる: phá, rách
敗れる: やぶれる: bị thua, bị đánh bại
敗北: はいぼく: thắng (văn phong lịch sự)
雇う: やとう: tuyển dụng (chỉ đi với người)
乱れる: みだれる: hỗn loạn, lộn xộn
防止: ぼうし: đề phòng
割り勘: わりかん: chia ra tính tiền
重ねる: かさねる: thu lại kết quả (trải qua rất nhiều đau khổ, thử thách)
尋ねる: たずねる: hỏi (= 聞きます)
焦る: あせる nóng vội
焦げる:こげる: cháy (đồ ăn)
認める:みとめる: thừa nhận, công nhận
測る: はかる: đo (dùng cho mọi bối cảnh)
計る: はかる: đo (thời gian, đếm số lượng)
量る: はかる: đo (khối lượng)
図る: はかる: lập kế hoạch
荒れる: あれる: động (biển, sóng), hỗn loạn, nứt nẻ (da)
暴れる:あばれる: quấy, làm rùm beng
責める:せめる: đổ lỗi
攻める: せめる: tấn công, công kịch
避ける:さける: tránh né (ánh mặt trời, người, ánh nhìn, cả trừu tượng, tránh phát ngôn)
すれ違う:すれちがう:  đi ngang qua nhau, bất đồng ý kiến
ためらう: lưỡng lự, đắn đo
かじる: cắn, gặm, học sơ sơ qua
掴む:つかむ: có trong tay, có cơ hội, nắm bắt tâm lý
ひっくり返す: lật lại (lật mặt, lật bánh)
裏切る: うらぎる:  phản bội, đi ngược lại kì vọng
ふざける: đùa cợt
慰める:なぐさめる: an ủi (1 ai đó gặp thất bại, thất tình)
ぎっしり: nhét chặt, chèn chặt
恨む: うらむ: ghét, căm phẫn
悔やむ:くやむ: hối hận, hối tiếc
飛びつく: lao đầu vào (nghĩa tiêu cực)
駆け込む: かけこむ: chạy lao vào (tàu chuẩn bị chạy)
思いつく: nãy ra, nghĩ ra (ý tưởng)
受け入れる: tiếp nhận (người, ý kiến - có tính chất thụ động)
取り入れる: đưa vào, áp dụng (chủ động)
盛り上がる: làm sôi nổi
打ち消す: phủ định, xóa bỏ (lời đồn)
打ち明ける: giải bày, hé lộ (chuyện bí mật, tâm tư)
打ち合わせる: cuộc họp nhỏ (chuẩn bị cho việc SẮP DIỄN RA)
打ち上げる: bắn pháo hoa
除く: のぞく: loại bỏ (vật không tốt, có hại), ngoài ra
取り除く: loại bỏ (lấy ra để loại bỏ)
用いる: もちいる dùng, sử dụng (nhóm 2, dùng business)
耐える: たえる: cam chịu, chịu (động đất)
訴える:うったえる: kiện, khiếu nại, kêu ca, tác động (tâm lý, tâm tư)
負う: おう: đảm nhận, gánh vác, bị thương
借金: しゃっきん: tiền vay
脅かす: おどかす: hù (làm cho giật mình, k phải đe dọa)
脅かす: おびやかす: đe dọa (trong bối cảnh nghiêm trọng)
占める: しめる: chiếm
薄める: うすめる: làm nhạt
求める: もとめる: yêu cầu
認める: みとめる: thừa nhận
ずれる: bị trật, lệch (đường ray, cút áo), lệch lạc (quy chuẩn)
支える: ささえる: ủng hộ, chống đỡ
頼る: たよる: phụ thuộc, dựa dẫm, nhờ vã
逆らう: さからう: đi ngược lại, chống đối
捻る:ひねる: vặn, xoay (vòi nước, mắt cá chân), (câu hỏi) đánh đố
静まる: しずまる: lắng xuống (lớp trở nên yên lặng)
転がる: lăn lông lốc, lăn qua lại trên giường, (chuyện) ở đâu cũng có
味わう: あじわう: nếm đồ ăn, nếm qua sự đời, trải nghiệm
設ける: もうける: tạo ra, thiết lập (tiêu chuẩn, quy chuẩn), trang bị, chuẩn bị (hội trường,  cơ hội, thời gian)
震える: ふるえる: rung lắc (sợ, tòa nhà rung)
ぶるぶる震える: run lẩy bẩy
誓う:ちかう: thề, ước
むかつく: bực bội, khó chịu (=怒る - おこる)
頭にくる: giận (= 腹が立つ - giận)
呼び止める: gọi lại
仕上げる: 完成する: hoàn thành (=終える)
負債: ふさい: khoản nợ
負担: ふたん: gánh nặng
ああだこうだ: nói lung tung
投影: とうえい: quy chụp
当てはまる: so sánh
簡潔: かんけつ: tinh gọn, tối giản
それより = そのより = なんにより: hơn tất cả, hơn hết (trong bài nghe, thường nội dung phía sau sẽ là đáp án đúng)
原稿: げんこう: bản thảo
(に)相応しい: ふさわしい: (ai đó) thích hợp, phù hợp (với việc)
わがまま: ích kỉ (= 勝手 - かって )
心強い: こころづよい: vững tâm
質素:しっそ: (cuộc sống 生活) đạm bạc
慌ただしい: あわただしい: (công việc) bận tối mắt tối mũi
物足りない: ものたりない: thiếu thiếu, không đủ (cảm giác không vừa lòng)
騒々しい: そうぞうしい: ồn ào = うるさい = やかましい
やかましい: ồn ào, khó tính (thường đi với âm thanh)
そそっかしい: hấp tấp, hậu đậu (dùng dể chê bai, tính cách)
厚かましい:あつかましい: mặt dày = ずうずうしい
くどい : しつこい: dài dòng, lắm lời
深刻: しんこく: nghiêm trọng,  (thường đi với トラブル, 問題, 悩み)
合同: ごうどう: hợp sức, kết hợp (cùng làm)
乏しい: とぼしい: nghèo (về dinh dưỡng, tài nguyên, kinh nghiệm)
貧しい: まずしい: nghèo (về kinh tế)
重苦しい: おもくるしい: nặng nề (bầu không khí)
痛ましい: いたましい đau (vết thương, buồn)
情けない: なさけない: thảm hại, thê thảm
差し支える: さしつかえる: vướng, gây phiền (gây cản trở cho công việc =問題 / 差し支えない - không phiền = かまわない)
輝かしい: かがやかしい:  thành tích rực rỡ, ánh đèn rực rỡ
たくましい: (vóc dáng) lực lưỡng, mạnh mẽ, (sống) lạc quan たくましい生く
穏やか: おだやか: (thời tiết) ôn hòa, (người) điềm đạm
緩やか: ゆるやか: (dốc) thoải, (môi trường làm việc) thoải mái
哀れ: あわれ: đáng thương = かわいそうな
だらしない: vô trách nhiệm, cẩu thả, bừa bộn (cuộc sống)
騒がしい:さわがしい: ồn ào =うるさい
くだらない: không có giá trị (=値段がない)
頭に来る: nổi giận = 腹が立つ
頑丈: がんじょう: bền (đồ vật)
順調: じゅんちょう: thuận lợi (công việc, kế hoạch)
柔軟: じゅうなん: linh hoạt, mềm mại (nghĩa bóng - vận động, suy nghĩ, ứng biến)
安易: あんい: dễ dàng, dễ dãi (dễ tin)
気軽: きがる:  nhẹ nhàng, thoải mái (phát biểu)
手軽: てがる: đơn giản (không tốn sức, không cồng kềnh)
気軽: きがる: thoải mái (thoải mái phát biểu, không cần nghĩ ngợi)
でたらめ: bừa (khoanh bừa) うそをつく: nói dối
物騒: ぶっそう: loạn lạc, nguy hiểm (nói về khu vực nguy hiểm)
ごちゃごちゃ: bừa bộn, lộn xộn (đồ vật, căn phòng)
ぐちゃぐちゃ: bừa bộn
好調: tốt (tình hình kinh doanh, thành tích)
多大: ただい: ảnh hưởng to lớn
大まか: sơ lược, tóm tắt chung chung
冷静: bình tĩnh, không hoảng loạn (trong trường hợp khẩn cấp =落ち着く)
平気 = 大丈夫: (nghĩa bóng: điềm nhiên như không)
機敏: きびん: lanh lẹ
かすか: (nhìn, nghe) thấp thoáng 聞こえる、見える
いい加減: (chê) vô trách nhiệm, 1 vừa 2 phải いいかげんにしろ
しかも: hơn nữa (nghĩa 2 câu là cùng chiều) = さらに = それに
まさか: làm gì có như thế đâu, bất ngờ (với chuyện)
それがね: thật ra thì (vế sau mới là sự thật) = 実は
ひょっとして = もしかて: không lẽ là, không chừng là (dự báo)
絞れる: しぼれる: vắt (khăn), chọn lọc (thông tin)
不可欠: ふかけつ: không thể thiếu
マスト: must: cần phải (không thể thiếu)
担う: になう: cáng đáng, gánh vác (将来を担う)
担ぐ: かつぐ: khiêng vác, mê tín, lừa đảo
じろじろ: nhìn chằm chằm (đi với 見る)
案の定: đúng như dự đoán (= やっぱり)
どろどろ: nhão nhoẹt (bột, bùn)
べたべた: nhớp dính
かさかさ: khô ráp
のんびり: thong thả (tận hưởng)
温厚: おんこう: (tính cách) hiền lành, hòa nhã, nồng hậu
はきはき: rõ ràng, rành mạch (cách nói, đối đáp)
生き生き: sinh động, đầy sức sống (cảm giác, trạng thái tinh thần)
さっさと: nhanh chóng (cần có ~ください, ra lệnh)
こつこつ: kiên nhẫn từng chút 1
直に: じかに: trực tiếp ( = 直接)
すっきり: thoải mái (cảm giác nhẹ nhỏm)
ぎっしり: (xếp đồ không còn chỗ trống) chật kín
きっぱり: kiên quyết từ chối (đi với 断る: ことわる)
たびたび: nhiều lần (lặp lại nhiều lần, thường mang nghĩa tiêu cực, làm phiền = 何度も = しょっちゅう)
ぶかぶか: thùng thình (quần áo rộng =とても大きい)
うとうと: gật gù (thường đi với thiếu ngủ)
さっぱり: hoàn toàn (chẳng hiểu gì)
ぴったり: vừa vặn
一変: いっぺん: thay đổi (tốc độ)
一転: いってん: thay đổi hoàn toàn (mọi thứ đều đã thay đổi)
愉快: ゆかい:  sảng khoái, thoải mái (thú vị = 面白い)
不快:ふかい:khó chịu, không thoải mái
一気に: (làm hết, uống hết) trong 1 hơi
およそ: dự đoán (= だいたい)
一斉に: いっせいに: đồng loạt, đồng thời (cùng nhau)
一旦: いったん: một lúc, trước mắt (tạm thời, 1 khi đã A thì)
たまたま: tình cờ gặp gỡ ( = 偶然)
ひそひそ: thì thầm (nói với nhau) =ささやく=小声で
うろうろ: lòng vòng (đi lại)
ばっさり: kiên quyết, thẳng tay (= 思い切る)
ぎりぎり: sát nút (giờ, thời gian)
ばったり: bất ngờ, tình cờ (gặp)
がらがら: trống vắng (xe điện trống)
ぐったり: mệt mỏi rã rời = くたくた
すっきり: nhẹ nhỏm (tâm trạng)
しっかり: chắc chắn, nghiêm túc (suy nghĩ)
直ちに: ただちに: ngay lập tức (thường đi với nghĩa chủ động, mệnh lệnh, thông báo, sai khiến = すぐに = 至急)
たちまち: ngay lập tức (vế sau là câu kể, không có ý chí = あっという間に ngay sau khi nói - cảm nhận của người nói = すぐに = 至急)
とっくに: đã được 1 lúc rồi (phải chia về thể hiện tại)
せめて: tối thiểu là (tôi muốn là ít nhất phải, ý chí)
少なくとも: すくなくとも: ít nhất là (phía sau là câu kể)
どうせ: đằng nào thì cũng (vế sau thường đi với なら)
主原料: しゅげんりょう: nguyên liệu chính
主成分: しゅせいぶん: thành phần chính
読書離れ: どくしょはなれ: rời xa việc đọc sách
決定権: けっていけん: quyền quyết định
所有権: しょゆうけん: quyền sở hữu
ヨーロッパ風: ふう : phong cách châu Âu
会社員風: かいしゃいんふう: người phong thái đi làm
一位: いちい đứng vị trí thứ 1
招待状: しょうたいじょう: thư mời
異文化: いぶんか: nền văn hóa khác nhau
温度差: おんどさ: chênh lệch nhiệt độ
触れる: ふれる: chạm, tiếp xúc (với thứ trừu tượng)
触る: さわる: chạm (vật lý)
年代順: ねんだいじゅん: theo trình tự thời gian
管理下: かんりか: dưới quyền quản lí
再開発: さいかいはつ: sử dụng lại
再発行: さいはっこう: phát hành lại
結婚観: けっこんかん: quan điểm hôn nhân
政治観: quan điểm chính trị
価値観: giá trị quan
高水準: こうすいじゅん: mức độ cao
日本式: にほんしき: nghi thức theo kiểu Nhật
原則: げんそく: nguyên tắc
未使用: みしよう: chưa sử dụng
未成年: みせいねん: vị thành niên
未決定: みけってい: chưa quyết định
初年度: しょねんど: năm đầu tiên
初会: người gặp lần đầu
初心者: しょしんしゃ: người mới
前社長: ぜんしゃちょう: giám đốc cũ (mới sát đây)
元社長: もとしゃちょう: giám đốc cũ (rất lâu về trước)
会員制: かいいんせい: chế độ hội viên
予約制: よやくせい: (qui định) đặt chỗ trước
低カロリー: てい : hàm lượng calo thấp
真後ろ: まうしろ: ngay sau
真っ白: まっしろ: trắng tinh
住宅街: じゅうたくがい: khu dân cư
不正確: ふせいかく: không chính xác
(勉強)漬け: づけ: đắm mình trong (việc học)
家族連れ: かぞくつれ: dẫn theo gia đình
従う: したがう: kéo theo, tuân theo
伴う: ともなう: dẫn theo
プレースメントテスト: placement test: kì thi đầu vào
延滞: えんたい: trễ hạn
罰金: ばっきん: tiền phạt
罰則期間: ばっそくきかん: thời gian phạt
創造: そうぞう: sáng tạo
逆らう: さからう: đi ngược lại, chống đối
劣る: おとる: thua người khác
辛い: つらい: đau đớn
最接近: さいせっきん: tiến gần nhất
名選手: めいせんしゅ: cầu thủ nổi tiếng
名所: めいしょ: nơi nổi tiếng
対抗心: たいこうしん: cự cãi
諸手続き: しょてつづき: nhiều thủ tục
本登録: ほんとうろく: đăng kí thật
仮登録: かりとうろく: đăng kí tạm thời
食べ頃: たべごろ: thời điểm tốt nhất để ăn
却下: きゃっか: từ chối, bác bỏ
決意: けつい: quyết tâm 
じろじろ: (nhìn) chằm chằm
うっかり: lơ đễnh: ミス
廃止: はいし hủy bỏ (đi với dịch vụ 制度、ルール)
解約: かいやく: hủy (hợp đồng)
中止: ちゅうし: cấm, ngừng, hủy bỏ (大雨、雨)
解消: かいしょう: giải tỏa, hủy bỏ (ストレス、問題)
ニーズ: nhu cầu (đáp ứng)
臨時: りんじ: tạm thời
雇う: やとう: tuyển dụng
交渉: こうしょう: đàm phán (値段、開放)
通話: つうわ: gọi điện thoại
劇的に: げきてきに: kịch tính
格別に: かくべつに: khác biệt, đặc biệt
真剣に: しんけんに: nghiêm túc
強大に: きょうだいに: mạnh mẽ, hùng mạnh
くるむ: gói (túm rác lại) = 包む(つつむ) gói cẩn thận, gói quà
衝突: しょうとつ: xung đột, chạm trán
打ち明ける: うちあける: hé lộ (秘密、悩み、過ち - lỗi lầm, sai lầm)
対処:たいしょ: đối phó, xử lý (vấn đề)
処置:しょち: điều trị, chữa bệnh
処分:しょぶん: xử lý, vứt bỏ, xử phạt
歌詞:かし: lời bài hát
台詞:せりふ: lời nói, lời thoại
消防団:しょうぼうだん: đội cứu hỏa
応援団:おうえんだん: đội cổ vũ
求人:きゅうじん: tuyển dụng, tìm người
(が)混じる:まじる: bị lẫn, lẫn vào
(を)訪ねる:たずねる: đến thăm, ghé thăm
誤解: ごかい: hiểu lầm
行事: ぎょうじ: sự kiện (mang tính định kì,イベント là không mang tính định kì, tổ chức bất chợt)
脂肪:しぼう: chất béo, mỡ
油断:ゆだん: lơ đễnh, chủ quan
好調:こうちょう: thuận lợi
収集:しゅうしゅう: thu thập, tập hợp
訪れる:おとずれる:đến thăm
収める:おさめる: cất giữ, thu dược, đạt được
吸収: きゅうしゅう: hấp thụ
下降: かこう: hạ xuống, giảm xuống
願望:がんぼう: nguyện vọng, mong muốn
適切:てきせつ: thích hợp
収穫:しゅうかく: thu hoạch
体験:たいけん: trải nghiệm
腕前:うでまえ: tay nghề
腕力:わんりょく:sức tay
開会式:かいかいしき: lễ khai mạc
人材:じんざい: nhân lực
天井:てんじょう: trần nhà
柔軟:じゅうなん: linh hoạt, mềm dẻo
弱点:じゃくてん: điểm yếu, nhược điểm
アンコール: (yêu cầu) hát lại, biểu diễn lại
集団:しゅうだん: nhóm, tập thể
賛否:さんぴ: ý kiến tán thành và phản đối
比較的な:ひかくてきな: tương đối (khi so sánh với mức trung bình)
圧倒的な:あっとうてきな: mang tính áp đảo
和やか:なごやか: hòa nhã, nhẹ nhàng, ôn hòa
保つ:たもつ: giữ, duy trì (nhiệt độ, đồ vật)
任せる:まかせる: giao phó
積もる:つもる:chất, chất đống
詰め込む:つめこむ: nhét vào, tống vào
密閉: みっぺい: đóng kín, bịt kín
垂直:すいちょく: thẳng đứng, vuông góc
激しい: はげしい: mạnh mẽ, dữ dội
賃貸: ちんたい: cho thuê
鑑賞: かんしょう: chiêm ngưỡng
隔て: へだて: sự phân biệt, cách khoảng
損得:そんとく: sự được mất, thiệt hơn
損失:そんしつ: tổn thất, thiệt hại
逃亡:とうぼう: bỏ trốn, lưu vong
切り捨てる:きりすてる: cắt bỏ đi phần dư, làm tròn số
(に)伴う:にともなう: đi cùng với, kéo theo
俳優: はいゆう: diễn viên
貨物: かもつ: hàng hóa
受賞:じゅしょう: nhận thưởng, được trao giải
拾う:ひろう: nhặt, lượm
将棋:しょうぎ: cờ tướng Nhật
豊か:ゆたか: giàu có, phong phú
豊富:ほうふ: phong phú, giàu kinh nghiệm
昼夜:ちゅうや: ngày đêm
内外: ないがい: trong ngoài
拒む:こばむ: từ chối
拒否: きょひ: từ chối
競技:きょうぎ: thi đấu
逃避:とうひ: trốn tránh, chạy trốn
一律:いちりつ: đồng loạt, đồng đều, không phân biệt
逮捕: たいほ: bắt
容疑:ようぎ: chứng cứ
本音:ほんね: thật lòng
換算:かんさん: chuyển đổi (tiền tệ, đơn vị)
交渉: こうしょう: thương lượng, thảo luận
退学処分: たいがくしょぶん: đuổi học
消除:しょうじょ: loại bỏ, xóa bỏ
過激:かげき: quá khích, cực đoan
乱暴:らんぼう: thô bạo, bạo lực
鮮やかな:あざやかな: rực rỡ, sáng sở
縁起:えんぎ: điềm báo
名演技:めいえんぎ: buổi biểu diễn tuyệt vời
技:わざ: kỹ năng
捕まる:つかまる: bắt giữ
採る:とる: hái
浴衣:ゆかた: bộ yukata
沼:ぬま: đầm lầy
夜景:やけい: cảnh đêm
釘:くぎ: cây đinh
漁業:ぎょぎょう: ngư nghiệp
漁師:りょうし: ngư dân
丘:おか: ngọn đồi
浜:はま: bờ biển
溶岩:ようがん: dung nham
清い:きよい: thanh khiết
清潔:せいけつ: thanh khiết
枕:まくら: gối
こだわる: suy nghĩ nhiều, chọn lọc kĩ càng
荒れる:あれる: bão táp, sóng gió
分析的:ぶんせきてき: có tính phân tích
材質:ざいしつ: chất liệu
柱:はしら: cột trụ
壮大:そうだい: tráng lệ, nguy nga, hùng vĩ
起床:きしょう: thức dậy
核心:かくしん:trọng tâm
北極:ほっきょく: Bắc Cực
南極:なんきょく: Nam Cực
栄える:さかえる: phồn thịnh
どしどし: không do dự, không ngần ngại (tới thẳng vấn đề)
すくすく: nhanh chóng
相応しい: ふさわしい: thích hợp
うっとうしい: u ám, chán nản
人格:じんかく: nhân cách
飼い主:かいぬし: người nuôi (thú cưng)
低い:ひくい:thấp
素人:しろうと:người nghiệp dư
玄人:くろうと:người chuyên nghiệp
素直:すなお: chân thành, ngoan
系統:けいとう: hệ thống, dòng họ
専念:せんねん: chuyên tâm
築く:きずく: xây dựng
物騒: ぶっそう: bất an
幻像:げんぞう: ảo tưởng, giấc mơ
幻覚:げんかく: ảo giác
消毒:しょうどく: khử độc, sát khuẩn
短編:たんぺん: truyện ngắn, phim ngắn
縮小:しゅくしょう: thu nhỏ
圧縮:あっしゅく: nén lại
縮れる:ちぢれる: nhăn lại, rút lại
絡まる:からまる: vướng vào, mắc vào
酸素:さんそ: khí oxi
二酸化炭素:にさんかたんそ: khí Co2
絶好調: ぜっこうちょう: phong độ đỉnh cao
恐縮:きょうしゅく: thật ngại, xin lỗi đã làm phiền, cảm ơn vì được giúp đỡ
悪口:わるくち: nói xấu
詐欺師:さぎし: kẻ lừa đảo
滞在時間:たいざいじかん: thời gian lưu trú
彼奴:あいつ: nó, thằng ấy, cô ấy
養う:やしなう: nuôi dưỡng
争う:あらそう: gây gỗ, tranh giành
おだてる: tâng bốc, (おだてられる: được tâng bốc)
過剰:かじょう: quá mức
規律:きりつ: kỉ luật
種:たね: hạt giống
細菌:さいきん:vi khuẩn
投げる:なげる: ném
跳ぶ:とぶ: nhảy lên, nhảy
飛ぶ:とぶ: bay
特技:とくぎ: sở trường
相互:そうご: lẫn nhau, từ 2 phía
礼儀:れいぎ: lễ nghi
焦る:あせる: hấp tấp, vội vã
暮らす:くらす: sống
恐怖:きょうふ: nỗi sợ, nỗi kinh hoàng
恐れる:おそれる: sợ, lo sợ
後悔:こうかい: hối hận
過去:かこ: quá khứ
窓際:まどぎわ: cạnh cửa sổ, mép cửa sổ
窓側:まどがわ: (ghế) phía cửa sổ
恵み:めぐみ: ân huệ
志望:しぼう: nguyện vọng, mong muốn
惜しい:おしい: đáng tiếc, quý trọng
悔しい:くやしい: tiếc nuối
簡潔:かんけつ: ngắn gọn, vắn tắt
知恵:ちえ: trí tuệ, thông thái
徹夜:てつや: thức trắng đêm
参照:さんしょう: tham chiếu
不潔:ふけつ: dơ bẩn, không sạch sẽ
快調:かいちょう: trạng thái tốt, đang tiến triển tốt
快晴:かいせい: trời đẹp, quang mây
優れる:すぐれる: giỏi, ưu tú
優良:ゆうりょう: ưu tú, chất lượng tốt
照明:しょうめい: chiếu sáng
記号:きごう: kí hiệu
心細い:こころぼそい: đơn độc, bất an
照らす:てらす:chiếu sáng
譲る:ゆずる: nhường, nhường lại
招く:まねく: mời
志願:しがん: tình nguyện
怪しい:あやしい: đáng ngờ
いじめる: bắt nạt
別荘:べっそう: biệt thự
刻む:きざむ: băm nhỏ
削る:けずる: gọt (bút chì)
彫刻:ちょうこく: điêu khắc
彫る: ほる: điêu khắc
掘る:ほる: đào
堀:ほり: hào, rãnh
罪を犯す:つみをおかす: phạm tội
時差:じさ: chênh lệch múi giờ
真剣:しんけん: nghiêm túc
姿勢:しせい: tư thế
演劇:えんげき: vở kịch
罰金:ばっきん: tiền phạt
高齢化:こうれいか: già hóa dân số
家族連れ:かぞくづれ: dẫn theo gia đình
隠す:かくす: che giấu
心がける:こころがける:cố gắng,chú tâm
企業:きぎょう: doanh nghiệp, công ty
大手企業:おおてきぎょう: doanh nghiệp lớn
大企業:だいきぎょう: doanh nghiệp lớn
接客:せっきゃく: tiếp khách
強盗:ごうとう: cướp
容姿:ようし: ngoại hình
外科:げか: khoa ngoại
児童:じどう: nhi đồng, thiếu nhi
育児:いくじ: nuôi con nhỏ
魚介類:ぎょかいるい: hải sản
作物:さくもつ: nông sản, hoa màu
要領:ようりょう: cách làm, phương pháp
刑事:けいじ: hình sự
刺す:さす: đâm
海辺:うみべ: bờ biển
霧:きり: sương mù
間際:まぎわ: ngay trước khi, sắp sửa
直線:ちょくせん: đường thẳng
壁際:かべぎわ: cạnh tường, mép tường
頂戴:ちょうだい: nhận (khiêm nhường ngữ
共用:きょうよう: sử dụng chung
祭る:まつる: thờ cúng
鋭い:するどい: sắc nhọn, bén
均等:きんとう: đồng đều, công bằng
動揺:どうよう: dao động, rung lắc, bất an (=不安)
直結:ちょっけつ: kết nối trực tiếp
直径:ちょっけい: đường kính
明らか:あきらか: rõ ràng
中立:ちゅうりつ: trung lập
競馬:けいば: đua ngựa
宝石:ほうせき:đá quý
骨折:こっせつ: gãy xương
通用:つうよう: thông dụng, được sử dụng phổ biến
中世:ちゅうせい: Thời Trung cổ
競う:きそう: cạnh tranh, thi đấu
心がける:こころがける: cố gắng, quyết tâm
通達:つうたつ: thông báo, thông tư
宗教:しゅうきょう: tôn giáo
ぐらぐら: lung lay, lắc lư, dao động (tinh thần)
がらがら: trống rỗng, vắng tanh (âm thanh) lách cách
バラバラ: tơi tả, rời rạc, chia rẽ
バレバレ: lộ liễu
たまたま: tình cờ, ngẫu nhiên
ますます: càng ngày càng
堂々と:どうどうと: 1 cách đàng hoàng, tự tin
陰:かげ : bóng, sau lưng
影:かげ: bóng, bóng dáng
隠れる:かくれる: ẩn nấp, trốn
販売元:はんばいもと: nhà phân phối, người bán
名場面:めいばめん: cảnh nổi tiếng
持ち主:もちぬし: chủ (sở hữu)
やがて: chẳng mấy chốc (=時間がたてば)
既定:きてい: qui định sẵn, mặc định
居心地:いごこち: cảm giác, cảm nhận được khi ở 1 nơi nào đó (1 nơi thoải mái)
魅力:みりょく: sức hút, sự hấp dẫn
念頭に置く:ねんとうにおく: ghi nhớ trong đầu, để tâm
詰まらない:つまらない: chán, không ra gì
行為:こうい: hành động, hành vi
構え:かまえ: chuẩn bị (tinh thần ứng phó), kiểu cách
通信教育:つうしんきょういく: lớp học trực tuyến (online class)
良好:りょうこう: tốt, tốt đẹp
転倒:てんとう: ngã lộn nhào
誇らしい:ほこらしい: tự hào, tự mãn
情景:じょうけい: phong cảnh, quang cảnh
著書:ちょしょ: tác phẩm
物質:ぶっしつ: vật chất
部署:ぶしょ: phòng ban
望遠鏡:ぼうえんきょう: kính viễn vọng
顕微鏡:けんびきょう: kính hiển vi
心境:しんきょう: tâm tư
境目:さかいめ: ranh giới, làn ranh
境界:きょうかい:ranh giới
控える:ひかえる: hạn chế, kiềm chế
糖分:とうぶん: lượng đường
(に) 就く:つく: đảm nhận, nhận việc
(に) 就任:しゅうにん: nhận chức (vị trí, công việc)
警備:けいび: bảo vệ
達成感:たっせいかん: cảm giác đạt được
急上昇:きゅうじょうしょう: tăng nhanh đột biến
内緒:ないしょ: bí mật
優秀:ゆうしゅう: ưu tú
ストレート: thẳng thắng, trực tiếp
凍える:こごえる: lạnh cóng
凍る:こおる: đông đá, đóng băng
更ける:ふける: trở nên muộn, đêm khuya
昇る:のぼる: tăng lên, (mặt trời) mọc
在学:ざいがく: (đang theo) học
署名:しょめい: kí tên
係員:かかりいん: người phụ trách
著者:ちょしゃ: tác giả
突き当たり:つきあたり: cuối đường
視覚:しかく: thị giác
業界:ぎょうかい: ngành
結末:けつまつ: kết cục
著しい:いちじるしい: nổi bật
文章:ぶんしょう: bài văn, đoạn văn
響く:ひびく: vang vọng
雷:かみなり:sấm xét
犯罪:はんざい: phạm tội 
薄暗い:うすぐらい: hơi tối, thiếu ánh sáng
解消:かいしょう: giải quyết
発言:はつげん: phát ngôn
裁判:さいばん: xét xử, kết án
少子化:しょうしか: tỉ lệ sinh giảm
鎖:くさり: dây xích
区分:くぶん: phân chia
遺産:いさん: di sản
簡略:かんりゃく: giản lược
形式:けいしき: hình thức, định dạng
巣:す:tổ (chim)
組:くみ: tổ, nhóm, set
唇:くちびる: môi
異国:いこく: nước khác
薄味:うすあじ: vị nhạt
しゃがむ: ngồi xổm
語る:かたる: kể về
課す:かす: giao, áp đặt
怒鳴る:どなる: gào lên, hét lên
戦う:たたかう: đấu, tranh đấu
生える:はえる: mọc (lên)
必死:ひっし:quyết tâm
明かり:あかり: ánh sáng, ánh đèn
専属:せんぞく: độc quyền, chuyên trách
差異:さい: sự khác nhau
苦難:くなん: khó khăn, gian khổ
不気味:ぶきみ: đáng sợ, bất an
悪化:あっか: tồi tệ hơn, xấu đi
暗闇:くらやみ: bóng tối
半透明:はんとうめい: bán trong suốt
不細工:ぶさいく: vụng về, xấu xí
催促:さいそく: thôi thúc
一層:いっそう: hơn hẵn, hơn nhiều
予め:あらかじめ: chuẩn bị trước
くたびれて: mệt mỏi
家畜:かちく: gia súc
博士:はくし: tiến sĩ
薄っぺら:うすっぺら: hời hợt, mỏng manh
憎む:にくむ: ghét
折り畳みかさ:おりたたみかさ: dù gấp
(が) 滴る:したたる: nhỏ giọt, rơi xuống
童話:どうわ: truyện cổ tích
砂漠:さばく: sa mạc
砂:すな: cát
(が) 埋まる:うまる: được chôn
(を) 埋める:うめる: chôn
実践:じっせん: thực tiễn, thực hành
裕福:ゆうふく: giàu có, dư dả
福祉:ふくし: phúc lợi
心当たり:こころあたり: có chút kí ức về
点滴:てんてき: truyền nước
占う:うらなう: bói
口実:こうじつ:  viện cớ, viện lý do
後者:こうしゃ: người sau
載せる:のせる: đăng tải, chất lên
私語:しご: nói chuyện riêng
視聴者:しちょうしゃ: khán giả
言葉遣い:ことばづかい: cách sử dụng từ ngữ
横切る:よこぎる: băng qua
生かす:いかす: tận dụng, phát huy, cứu sống
踊る:おどる: nhảy múa
含める:ふくめる: bao gồm
交代:こうたい: thay phiên (tuần hoàn)
交替:こうたい:  thay 1 lần
独占:どくせん: độc chiếm
息切れ:いきぎれ: khó thở, hết hơi
ぐらぐら:rung lắc, sôi sùng sục, chóng mặt
がらがら: vắng tanh, khàn giọng
ごちゃごちゃ: lung tung, hỗn độn
こっそり: rón rén
うっかり: lơ đễnh, không để ý
ちかちか: nhấp nháy
うろうろ: loanh quanh, lãng vãng
ぎっしり: lèn chặt, kín lịch
あまろにも: quá, quá mức
叫ぶ:さけぶ: la hét, gào lên
吐き気:はきけ: cảm giác buồn nôn
小言:こごと: phàn nàn, trách mắng
異色:いしょく: khác biệt, độc đáo
やりがい: đáng làm
若々しい:わかわかしい: trẻ trung
健やか:すこやか:khỏe mạnh, khỏe khoắn
硬い表情:かたいひょうじょう: nét mặt cứng nhắc, biểu cảm cứng nhắc
隔てる:へだてる: ngăn cách, phân chia
教わる:おそわる: được dạy
通院:つういん:đi viện
親孝行:おやこうこう:hiếu thảo, báo hiếu
色彩:しきさい:màu sắc
劇場:げきじょう: nhà hát, rạp hát
大盛り:おおもり: suất ăn lớn
快い:こころよい: dễ chịu, thoải mái
芝居:しばい:kịch, diễn, diễn trò
急用:きゅうよう: việc gấp
開封:かいふう: mở phong bì, mở thư, mở gói hàng
乗り越す:のりこす: đi quá trạm
(に)引っ越し: ひっこし: chuyển nhà, dọn đi
同居:どうきょ: sống chung
趣味:しゅみ: sở thích
退屈:たいくつ: chán, buồn tẻ
所属:しょぞく: thuộc, trực thuộc
住居:じゅきょ: nơi ở, chỗ ở
後日:ごじつ: hôm khác, ngày hôm sau
根性:こんじょう: bản chất
封筒:ふうとう: phong bì
娯楽:ごらく: giải trí, tiêu khiển
根本:こんぽん: gốc rễ, căn bản
細胞:さいぼう: tế bào
細菌: さいきん: vi khuẩn
見逃す:みのがす: bỏ lỡ, bỏ qua, bỏ sót
至る:いたる: đạt đến
垂れる:たれる: rủ xuống, chảy xuống
腰かける:こしかける: ngồi xuống
ご無沙汰: ごぶさた: lâu rồi không liên lạc
属す:ぞくす: trực thuộc
反感:はんかん: ác cảm
歯車:はぐるま: bánh răng
献立:こんだて: thực đơn
握る:にぎる: nắm, giữ
癒す:いやす: làm dịu, chữa lành
差し支える:さしつかえる: cản trở
問いかける:といかける: hỏi
配分:はいぶん: phân phát, phân chia
進行:しんこう: tiến triển
超過:ちょうか: vượt quá
ぴかぴか: lấp lánh
はらはら: lo lắng
だぶだぶ: rộng thùng thình
作動:さどう: hành động, hoạt động (của máy móc)
気遣い:きづかい: quan tâm, lo lắng
狙い:ねらい: mục đích
廃止:はいし: hủy bỏ
決断:けつだん: quyết đoán
抽選:ちゅうせん: rút thăm
孤立:こりつ: cô lập
過ち:あやまち: lỗi lầm
半減:はんげん: giảm 1 nữa
現状:げんじょう: hiện trạng
素敵:すてき: đẹp
温もり:ぬくもり: ấm áp
背負う:せおう: đeo, gánh vác
殴る:なぐる: đấm
長年:ながねん: nhiều năm
施設:しせつ: cơ sở công cộng
切ない:せつない: đau lòng
あらすじ: nội dung tóm tắt
紙幣:しへい: tiền giấy
書物:しょもつ: sách vở
事業:じぎょう: dự án, công việc kinh doanh
破片:はへん: mảnh vỡ
縞:しま: sọc
破産:はさん: phá sản
霜:しも: sương giá
頭脳:ずのう: đầu não
手話:しゅわ: thủ ngữ
食卓:しょくたく: bàn ăn
信仰:しんこう: tín ngưỡng
当番:とうばん: phiên, ca trực
勝敗:しょうはい: thắng bại
勝負:しょうぶ: thắng thua
頭角:とうかく: năng lực
引き離す:ひきはなす: kéo ra
神経:しんけい: thần kinh
謎:なぞ: bí ẩn
縄:なわ: dây thừng
日光:にっこう: ánh nắng
及ぶ:およぶ: lan tới, ảnh hướng đến
入手:にゅうしゅ: có được trong tay
消耗:しょうもう: tiêu hao
芯:しん: ruột (bên trong)
宮殿:きゅうでん: cung điện
ふらふら: loạng choạng, không ổn định
ぶらぶら: lang thang, đong đưa
原理:げんり: nguyên lý, lý thuyết cơ bản
工芸:こうげい: thủ công mĩ nghệ
高水準:こうすいじゅん: tiêu chuẩn cao
並木:なみき: hàng cây
ひじ:khuỷu tay
ひざ: đầu gối
焦点:しょうてん: tiêu điểm
引き分け:ひきわけ: hòa, bất phân thắng bại
憲法:けんぽう: hiến pháp
心身:しんしん: cơ thể và tâm hồn
原子力:げんしりょく: năng lượng hạt nhân
神話:しんわ: thần thoại
芸能界:げいのうかい: giới nghệ thuật
芸能:げいのう: nghệ thuật thủ công
催し:もよおし: sự kiện, buổi lễ
訴える:うったえる: kiện, phản ánh
促す:うながす: thúc dục, khuyến khích
焦る:あせる: nóng vội
荒い:あらい: dữ dội, thô lỗ
余計:よけい: dư thừa, không cần thiết
怒る:おこる: nổi giận (= むかつく=腹が立つ - はらがたつ=かっとする)
一休み:ひとやすみ: nghỉ 1 lát
一段落:いちだんらく: tạm ổn
反発:はんぱつ: phản đối
ぐずぐず: chần chừ, lề mề
輝く:かがやく: lấp lánh, rạng rỡ
嗅ぐ:かぐ: ngửi
及ぼす:およぼす:làm ảnh hưởng, gây ra
勧誘:かんゆう: mời gọi, lôi kéo
審判:しんぱん: thẩm phán, trọng tài
生み出す:うみだす: tạo ra, mang lại
警告:けいこく: cảnh báo
絶える:たえる: dừng, ngưng
風船:ふうせん: bong bóng
褒める:ほめる: khen ngợi (BAO)
厳守:げんしゅ: tuân thủ nghiêm ngặt
日の出:ひので: bình minh
日の入り:ひのいり: hoàng hôn
敬う:うやまう: tôn trọng
(ひざが)曲げる:まげる: gập (đầu gối)
申告:しんこく: khai báo
蛍光灯:けいこうとう: đèn huỳnh quang
光源:こうげん: nguồn sáng
錠剤:じょうざい: thuốc viên
舞台:ぶたい: sân khấu
船便:ふなびん:đường biển
囲む:かこむ: bao quanh, bao bọc
左右:さゆう: trái phải
夫婦:ふうふ: vợ chồng
逆さ:さかさ: ngược lại
味方:みかた: đồng minh
気配:けはい: sự cảm giác, sự cảm thấy
測定:そくてい: đo lường
栄え:さかえ: phồn vinh
(を) 営む:いとなむ: kinh doanh
支度:したく: chuẩn bị
嫌がる:いやがる: ghét, không thích
解放感:かいほうかん: cảm giác tự do, được giải phóng
謙虚:けんきょ: (tính cách) khiêm tốn
放り出す:ほうりだす: buông bỏ, quẳng ra
徹底的:てっていてき: triệt để, kĩ lưỡng
抽象的:ちゅうしょうてき: tính trừu tượng
象徴的:しょうちょうてき: tính tượng trưng
用心的:ようじんてき: cẩn thận, thận trọng (=気をつけて)
目次:もくじ: mục lục
牧場:ぼくじょう: trang trại
容量:ようりょう: dung lượng
妊婦:にんぷ: người mang thai
妊娠:にんしん: mang thai
衛星:えいせい: vệ tinh
衛生:えいせい: vệ sinh
特徴:とくちょう: đặc trưng
予選:よせん: sơ tuyển, vòng loại
要所:ようしょ: địa điểm trọng yếu, điểm chính
要旨:よいし: nội dung chính
用語:ようご: thuật ngữ
ハト:bồ câu
バザー: hội chợ
謙遜:けんそん: (hành vi) khiêm tốn
憂鬱:ゆううつ: ủ rủ, chán nản
よそ者:よそもの: người ngoài, người lạ
往来:おうらい: vãng lai
迫る:せまる: tiếp cận, sát nút, cận kề
兼ねる: かねる: kiêm (nhiều việc 1 lúc)
明示:めいじ: biểu thị, chỉ rõ
姪:めい: cháu gái
甥:おい: cháu trai
放棄:ほうき: bỏ rơi, từ bỏ
放出:ほうしゅつ: thải ra, phóng
野生:やせい: hoang dã
横道:よこみち: đường cạnh, lạc đề
唯一:ゆいいつ: duy nhất
役人:やくにん: công chức
遺言:ゆいごん: di ngôn
キンキン: lạnh thấu xương, tiếng nói the thé
服従:ふくじゅう: phục tùng
仮病:けびょう: giả bệnh
旧姓:きゅうせい: họ thời con gái
逸れる:それる: bị lệch, trượt ra
放す:はなす: thả ra
物真似:ものまね: bắt chước
刺激:しげき: kích thích
縦:たて: chiều dọc
縦書き:たてがき: viết theo chiều dọc
嵐:あらし: bão (lớn)
爆発:ばくはつ: nổ, bộc phát
誘う:さそう: mời, rủ
誘い:さそい: lời mời
削減:さくげん: cắt giảm
暴れる:あばれる: quậy phá, làm loạn
精神的:せいしんてき: tinh thần
崩す:くずす: sụp, vỡ, phá hủy (cơ thể suy yếu)
香水:こうすい: nước hoa
委任状:いにんじょう: giấy ủy nhiệm, đơn ủy thác
崩れる:くずれる: sụp đổ
精々:せいぜい: tối đa, nhiều nhất có thể
情けない:なさけない: đáng thương, thảm hại
稼ぐ:かせぐ:kiếm tiền, câu giờ
委員:いいん: ủy viên
部門:ぶもん: bộ phận, hạng mục
過失:かしつ: thiếu sót, bất cẩn
味付け:あじつけ: nêm gia vị
粉:こな: bột, phấn
粒:つぶ: hạt
間取り:まどり:sơ đồ nhà
身振り:みぶり: cử chỉ cơ thể
身の回り:みのまわり: những việc xung quanh mình
身元:みもと: danh tính, lai lịch
岸:きし: bãi, bờ
炭:すみ: than
陰:かげ: bóng, sau lưng
直撃:ちょくげき: tiến thẳng đến, trực diện (bão)
密度:みつど: mật độ
味噌:みそ: súp miso
暴行:ぼうこう: bạo hành
手振り:てぶり: cử chỉ tay
密着:みっちゃく: gắn chặt, bám sát
挿す:さす: cắm, cài (hoa)
敷く:しく: trải (thảm)
鍛える:きたえる: rèn luyện
道のり:みちのり: quãng đường
灯台:とうだい: hải đăng
獲得:かくとく: giành được
合間:あいま: chỗ trống, thời gian rảnh
箇所:かしょ: nơi, chỗ
前進:ぜんしん: tiến lên phía trước (vị trí)
向上:こうじょう: tiến bộ, nâng cao
解釈:かいしゃく: diễn giải, lý giải
三日月:みかづき: trăng khuyết
ささやく: thì thầm
じたばたする: vùng vẫy, giảy dụa (=慌てる-あわてる vội vàng)
すすぐ: xúc (miệng)
頬:ほほ: cái má
万引き:まんびき: ăn cắp vặt
加工:かこう: gia công, xử lý chế biến
分配:ぶんぱい: phân phối
擦る:する: cọ sát
暴く:あばく: phơi bày
電灯:でんとう: đèn điện
灰:はい:tro
順位:じゅんい:thứ hạng, vị trí
各自:かくじ: mỗi người
身分:みぶん: thân phận
こだわる: để tâm
狂う:くるう: điên cuồng, phát điên
贅沢:ぜいたく: xa xỉ, sang chảnh
写す:うつす: chép lại, chụp ảnh
結ぶ:むすぶ:kết nối, buộc, ký (hợp đồng)
把握:はあく: nắm bắt, hiểu rõ
ずらす: dịch chuyển, làm lệch
生意気:なまいき: xấc xược
我慢:がまん: nhẫn nại, nhẫn nhục
軒: のき: mái (nhà)
授かる:さずかる: được ban cho
からかう: trêu chọc
季節:きせつ: mùa
酷い:ひどい: kinh khủng, tồi tệ
正直:しょうじき: thành thật
後遺症:こういしょう:di chứng
保証金:ほしょうきん: tiền cọc
渋い:しぶい: chát, trầm
緩やか:ゆるやか: lỏng lẻo, thoai thoải
加熱:かねつ: làm nóng dầu
昇進:しょうしん: thăng chức
盛ん:さかん: thịnh vượng
主義:しゅぎ: chủ nghĩa
鐘:かね: chuông
掲載:けいさい: đăng tải
続行:ぞっこう: tiếp tục
滑らか:なめらか: trôi chảy, mịn mạng
朗らか:ほがらか: tươi sáng, vui vẻ
賑やか:にぎやか: nhộn nhịp
事柄:ことがら: sự việc, vấn đề
繁盛:はんじょう: phồn vinh, thịnh vượng
為替:かわせ: tỉ giá hối đoái
対戦:たいせん: thi đấu
谷:たに: thung lũng
ため息:ためいき: thở dài
太鼓:たいこ: trống lớn
平ら:たいら: bằng phẳng
妥当:だとう: hợp lý, thích đáng
多様:たよう: đa dạng
莫大:ばくだい: khổng lồ
粗末:そまつ: thô kệch
液体:えきたい: dung dịch
体操:たいそう: bài thể dục
儀式:ぎしき: lễ nghi
体制:たいせい: thể chế
運営:うんえい: vận hành
容易:ようい: dễ dàng
陽気:ようき: vui vẻ, thời tiết đẹp
歩む:あゆむ: đi, bước đi, trải qua (cuộc đời)
只:ただ: chỉ là
炎症:えんしょう: viêm (da)
増加:ぞうか: gia tăng
炎:ほのお: ngọn lửa
証拠:しょうこ: chứng cứ
惨め:みじめ: đáng thương, thảm hại
群れ:むれ: bầy đàn
大騒ぎ:おおさわぎ: náo động, ầm ĩ
各々:おのおの: mỗi người, từng người
包帯:ほうたい: băng gạc
配布:はいふ: phân phối
猛暑:もうしょ: nắng nóng gay gắt
入荷:にゅうか: nhập hàng
開幕:かいまく: khai mạc
そそかし: cẩu thả
ばかばかしい: tào lao, vớ vẫn
みっともない: đáng xấu hổ
むなしい: vô ích
愚痴:ぐち: than vãn
架空:かくう: hư cấu
眩しい:まぶしい: chói mắt
恵み:めぐみ: phúc lành, ân huệ
取り扱う:とりあつかう:thao tác, xử lý, đối đãi
招く:まねく:mời, rủ
持ち寄る:もちよる:mang đến, mang theo để gộp lại
著書:ちょしょ: sách, tác phẩm 
盗む:ぬすむ:ăn cắp
謙遜:けんそん: khiêm nhường
一律:いちりつ:đồng loạt, đồng đều (đồng giá)
溜まる:たまる:đọng lại, dồn lại (đóng bụi)
勧める:すすめる: đề nghị, khuyên
略す:りゃくす: rút gọn, tóm gọn
捕まえる:つかまえる: bắt, tóm
悔しい:くやしい:hối hận, tiếc nuối
専攻:せんこう: chuyên ngành
頂く:いただく:nhận
指図:さしず:mệnh lệnh, ra lệnh
依然:いぜん: vẫn như mọi khi (=まだ)
取り掛かる:とりかかる: bắt tay vào làm việc
人柄:ひとがら:nhân cách, phẩm chất (=性格)
くるむ: bọc lại, quấn lại
包む:つつむ: đùm bọc
合理的:ごうりてき: hợp lý (logic)
まれ: hiếm hoi (=ほとんどない)
再三:さいさん: nhiều lần - nghĩa tiêu cực, đã nhắc nhở nhiều lần (=何度も) 
方々: ほうぼう: khắp mọi nơi (= あちこち)
そっくり:giống y xì (=似ている)
頭がきている:あたまがきている:tức giận (=怒っている)
精々:せいぜい:nhiều nhất là (=多くても)
ちっとも:1 chút cũng không
とうとう: cuối cùng thì (thường nêu ra 1 kết cục gì đó)
大当たり:おおあたり: trúng lớn
いっさい: hoàn toàn, tất cả (không liên quan)
見当: けんとう: dự đoán, phán đoán (thường gặp 見当がつかない - không ước chừng được)
音響: おんきょう: âm hưởng, âm thanh
旅行先:りょこうさき: điểm du lịch
びりびり: roẹt roẹt (xé giấy)
ばりばり: chăm chỉ, cần mẫn
むかむか: giận tím người
ぐっすり: ngủ ngon
評論家:ひょうろんか: nhà phê bình (phim, thời trang, ẩm thực)
書き込み:かきこみ: viết bình luận
除去:じょきょ:loại bỏ (chất độc hại)
消失:しょうしつ: tiêu biến, biến mất
消化:しょうか: tiêu hóa
倒壊:とうかい: sụp đổ, phá hủy
逆効果:ぎゃくこうか: phản tác dụng
ぐらぐら: rung lắc (động đất)
すらすら:trôi chảy, thành thạo
はらはら:lo lắng
ぶらぶら:loanh quanh, lang thang
できごと: sự kiện (=イベント)
ぐるぐる: xoay vòng tròn (miêu tả trạng thái xoay vòng tròn của 1 sự vật
ぐんぐん: vùn vụt, nhanh chóng (tăng trưởng =とても速く)
しっかり:chắc chắn (nghĩa bóng trấn tĩnh lại)
根気:こんき:kiên nhẫn, nhẫn nại (=こつこつ- kiên trì, từng chút một)
丸一日:まるいいちにち: trọn vẹn 1 ngày (tốn cả 1 ngày)
あらゆる:toàn bộ, tất cả (=すべて)
いずれ: 1 ngày nào đó (= いつかそのうちに - 1 lúc nào đó)
続出:ぞくしゅつ: liên tiếp xảy ra, kéo dài dai dẳng (thường mang nghĩa tiêu cực
誤作動:ごさどう:thao tác sai, thao tác nhầm
多機能:たきのう:đa tính năng
センス:có gu (ăn mặc, ăn uống, thẩm mỹ), có khiếu (nghệ thuật)
利害:りがい:mặt lợi và hại (ưu, nhược)
過半数:かはんすう:quá 1 nữa
調和:ちょうわ: hòa hợp, hài hòa
調節:ちょうせつ:điều tiết, điều chỉnh (âm thanh, nhiệt độ)
雷雨:らいう:mưa giông
どんどん: dần dần, đều đặn (=続々-ぞくぞく)
がんがん:đau đầu (ong ong), nói ầm ầm
ずんずん:lớn dần (số lượng tăng theo thời gian, thường đi với công việc hoặc ai đó bỏ đi)
 空席:くうせき:ghế trống
どうせ: đằng nào cũng, dù sao cũng
どうも: rất, vô cùng
移り:うつり:di chuyển, di dời
判子:はんこ:con dấu
じろじろ: nhìn chằm chằm
きょろきょろ: bồn chồn
でたらめに: trả lời bừa, làm bừa
着々と:ổn định (tiến triển tích cực)
ひそひそ: khe khẽ, thì thầm
のんびり: thong thả
ぱったり: đột ngột, bất ngờ
がらがら: phòng vắng vẻ, giọng khàn
ばっさり: dứt khoát
いきいき: sinh động
すっきり: thoải mái, dễ chịu
いらいら: sốt ruột, nóng nảy
ごろごろ: nằm lười làm biếng, không làm gì
ぶらぶら: đi lang thang, treo lủng lẳng
すらすら: trôn tru, trôi chảy
続々と: liên tục, không ngừng nghĩ
ばらばら: tơi tả, rời rạc (giấy, mảnh vỡ), lung tung (nhóm người)
ぐらぐら: lung lay (rangi, bàn ghế, tòa nhà)
くよくよ:lo lắng bồn chồn, không yên tâm
はきはき: minh bạch, rõ ràng, sáng suốt (trả lời, nói - ハキハキと答える)
こつこつ: siêng năng, chăm chĩ
ふわふわ:mềm mại, bồng bềnh (gối, tóc)
いきいき: đầy sức sống (đi với cảm xúc con người)
ぶかぶか: rộng thùng thình (đi với quần áo)
くたくた: mệt mỏi, kiệt sức
ますます: ngày càng hơn nữa
まずまず: kha khá, tàm tạm
めちゃめちゃ:quá mức, liều lĩnh không thận trọng
ぼろぼろ:tả tơi, te tua
ぼさぼさ: đầu tóc bù xù
ぎゅうぎゅう:chật ních, chật cứng
ぐうぐう: ngủ sâu, ngủ say
じめじめ: ẩm ướt
へとへと:mệt phờ phạt
そわそわ: nhấp nhổm, đứng ngồi không yên ( = 落ち着きがない)
ひやひや: ớn lạnh
諸問題:しょもんだい:các vấn đề về...
諸外国:しょがいこく:các nước khác (諸 hiểu là các ... )
集中力:しゅうちゅうりょく:khả năng tập trung
2対1:tỉ số 21
現段階:げんだんかい:giai đoạn hiện tại
ビジネスマン風:vẻ ngoài giống như businessman (ふう,hậu tố tả phong cách bên ngoài)
ヨーロッパ風:theo kiểu châu Âu
国際色:こくさいしょく:màu sắc quốc tế (政治色 màu sắc chính trị)
低価格:ていかかく: giá rẻ
日本流:にほんりゅう:kiểu Nhật (流 có thể hiểu theo style, アメリカ流-kiểu Mỹ)
親子連れ:おやこづれ: bố mẹ và con cái
風邪気味:かぜぎみ:cảm giác đang bị ốm
食器類:しょっきるい:các loại dụng cụ ăn uống
音楽全般:おんがくぜんぱん:tất cả thể loại âm nhạc
最有力:さいゆうりょく:quyền lực lớn nhất
電車賃:でんしゃちん:tiền tàu xe
一色:いっしょく:ngập tràn (màu sắc, không khí gì đó)
高性能:こうせいのう:tính năng cao
主成分:しゅせいぶん:thành phần chính
結婚観:けっこんかん:quan điểm hôn nhân
日本式:にほんしき:(cách thức kinh doanh) kiểu Nhật
勉強漬け:べんきょうづけ:học cắm đầu cắm cổ, học chăm chỉ
前社長:ぜんしゃちょう:giám đốc trước
不正確:ふせいかく:không chính xác
学年別:がくねんべつ:năm học khác nhau (phân theo năm học)
無計画:むけいかく:không có kế hoạch
頼みづらい:khó để nhờ (trở ngại, khó khăn về mặt tâm lý)
都会育ち:とかいそだち:lớn lên ở thành phố
一仕事:ひとしごと: 1 phần công việc
科学者:かがくしゃ:nhà khoa học
手数料:てすうりょう:tiền hoa hồng
譲る:ゆずる:nhượng lại, bán lại (=売る/あげます)
雑談:ざつだん:nói chuyện phiếm (=おしゃべり)
大げさ:おおげさ:nói quá lên (=オーバー)
見解:けんかい:quan điểm (dùng cho ng có trình độ chuyên môn =考え方)
ブーム: bùng nổ, trào lưu (=流行)
わずかに: 1 chút thôi (=少し=多少-たしょう)
追加:ついか:cộng thêm (=足す)
そうとう: khá là, tương đối là (=かなり)
じっとする:ở yên, không cử động (=動かない)
思いがけない:không ngờ đến, ngoài dự tính (=意外な)
自ら:みずから:tự thân - trang trọng (=自分で)
およそ: khoảng (=だいたい)
依然として:いぜんとして: vẫn như trước, không thay đổi (=相変わらず)
山のふもと:chân núi (=山ノ下の方)
揃える:そろえる:làm đồng loạt, giống nhau (=同じ)
明らか:あきらか:rõ rãng (=はっきり)
無口:むくち:ít nói (=あまり話さない)
やや:1 chút, ít (=少し)
かつて:trước kia, ngày xưa (=以前)
直に:じかに: trực tiếp (=直接)
卑怯:ひきょう: chơi ăn gian (=ずるい)
ついている:may mắn (=運が良い)
常に:つねに:thường xuyên (=いつも)
臆病:おくびょう:bị nhút nhát (=何でも怖がる)
とっくに:rất lâu rồi (=ずっと前に)
不平:ふへい:bất công (nói lời bất công=文句-もんく)
当分:とうぶん:tạm thời là, trước mắt là (=しばらく)
くどい:dài dòng, dai dẳng (=しつこい)
落ち込む:おちこむ: thất vọng (=がっかり)
定める:さだめる:quyết định, xác định (=決める)
かかりつけ: (quán) quen, (bệnh viện) quen (=いつも行く)
屋根:やね:mái nhà
堅実:けんじつ: vững chắc, chắc chắn, thiết thực
とがって: nhọn (=細く)
問い合わせる:といあわせる: hỏi (hỏi chi tiết qua mail, qua điện thoại để lấy thông tin)
会見:かいけん:họp báo (người nổi tiếng, chính trị gia)
鈍い:にぶい:cùn, chậm chạp, lề mề (=遅い)
ばっと:đột nhiên, đột ngột (=急に)
要するに:ようするに:tóm lại là (=つまり)
雪崩:なだれ:tuyết lở
草履:ぞうり:dép vải Nhật
音色:ねいろ:âm sắc
懸念:けねん:lo lắng, lo ngại
白米:はくまい:gạo trắng
軽率:けいそつ:hấp tấp, thiếu suy nghĩ
道端:みちばた:lề đường
下品:げひん: sản phẩm kém, (nghĩa bóng người thô tục)
解熱:げねつ:giảm sốt
解脱:げだつ:giải thoát (Phật giáo)
強引:ごういん:cưỡng ép
行方:ゆくえ:tung tích
素案:そあん:giản dị
手当:てあて:trợ cấp/sơ cứu
目安:めやす:mục tiêu, tiêu chuẩn
目処:めど:triển vọng, dự định
演説:えんぜつ:diễn thuyết
口調:くちょう:giọng điệu
めでたい:may mắn
耕す:たがやす:cày bừa
喧嘩:けんか:cãi nhau
喧しい:やかましい: Ồn ào - 音、声、子供が… / Lằng nhằng, phiền phức - 規則が…,（人)が… / Nghiêm khắc về - 時間に、マナーに…