天井	てんじょう	trần nhà; (mức giá) trần	THIÊN TỈNH
丼	どんぶり	bát lớn, cái tô	ĐẢM
〜丼	どん	bát cơm với thức ăn phủ lên trên	ĐẢM
周囲	しゅうい	xung quanh; những người xung quanh	CHU VI
範囲	はんい	phạm vi	PHẠM VI
雰囲気	ふんいき	bầu không khí, không gian; ấn tượng tổng thể, khí chất	PHÂN VI KHÍ
冗談	じょうだん	đùa, chuyện đùa	NHŨNG ĐÀM
台詞	せりふ	lời thoại (trong kịch, phim,...), lời nói, câu nói	ĐÀI TỪ
歌詞	かし	lời bài hát	CA TỪ
誤り	あやまり	lỗi sai, sự nhầm lẫn, sai sót	NGỘ
座布団	ざぶとん	đệm ngồi kiểu Nhật	TỌA BỐ ĐOÀN
集団	しゅうだん	nhóm, tập thể	TẬP ĐOÀN
団体	だんたい	đoàn thể, tổ chức, nhóm	ĐOÀN THỂ
脂肪	しぼう	mỡ, chất béo	CHI PHƯƠNG
収入	しゅうにゅう	thu nhập	THU NHẬP
人材	じんざい	nhân lực, nhân tài	NHÂN TÀI
天才	てんさい	thiên tài	THIÊN TÀI
オリンピック		Olympic	
開会式	かいかいしき	lễ khai mạc	KHAI HỘI THỨC
収穫量	しゅうかくりょう	sản lượng thu hoạch	THU HOẠCH LƯỢNG
状況	じょうきょう	tình trạng, hoàn cảnh, tình hình	TRẠNG HUỐNG
アンコール		biểu diễn thêm, hát thêm	encore
睡眠	すいみん	ngủ, giấc ngủ	THỤY MIÊN
腕前	うでまえ	tay nghề	OẢN TIỀN
要望	ようぼう	nguyện vọng, yêu cầu	YẾU VỌNG
リクエスト		yêu cầu, đề nghị	request
件	けん	vụ việc, trường hợp/ đơn vị đếm (vụ việc, email, sự kiện,...)	KIỆN
世間	せけん	xã hội, thiên hạ	THẾ GIAN
欲	よく	mong muốn, ham muốn	DỤC
賛否	さんぴ	ý kiến tán thành và phản đối	TÁN PHỦ
弱点	じゃくてん	điểm yếu, nhược điểm	NHƯỢC ĐIỂM
恥	はじ	sự xấu hổ	SỈ
強火	つよび	lửa mạnh, lửa to (khi nấu ăn)	CƯỜNG HỎA
現象	げんしょう	hiện tượng	HIỆN TƯỢNG
行事	ぎょうじ	sự kiện, hoạt động	HÀNH SỰ
好調	こうちょう	thuận lợi, (tiến triển) tốt	HẢO ĐIỀU
快い	こころよい	thoải mái, vui vẻ, sẵn lòng	KHOÁI
適切	てきせつ	thích hợp, phù hợp	THÍCH THIẾT
柔軟	じゅうなん	mềm dẻo, linh hoạt	NHU NHUYỄN
比較的	ひかくてき	tương đối, khá	BỈ GIÁC ĐÍCH
圧倒的	あっとうてき	áp đảo, vượt trội	ÁP ĐẢO ĐÍCH
和やか	なごやか	hòa nhã, nhẹ nhàng, ôn hòa	HÒA
異なる	ことなる	khác nhau	DỊ
保つ	たもつ	giữ, duy trì	BẢO
散る	ちる	rơi, tàn; phân tán	TÁN
重ねる	かさねる	chồng lên, chất lên; lặp lại nhiều lần	TRỌNG
務める	つとめる	đảm nhiệm, giữ vai trò	VỤ
任せる	まかせる	giao phó	NHÂM
積もる	つもる	chất đống, chồng chất	TÍCH
縮める	ちぢめる	rút ngắn, làm ngắn lại, làm co lại	SÚC
混じる	まじる	bị trộn lẫn, bị pha lẫn, lẫn vào	HỖN
迎える	むかえる	đón, chào đón; bước sang, đến (thời điểm, giai đoạn)	NGHÊNH
養う	やしなう	nuôi dưỡng; bồi dưỡng (kỹ năng, tinh thần)	DƯỠNG
争う	あらそう	tranh giành, tranh cãi, đấu tranh	TRANH
伺う	うかがう	hỏi (khiêm nhường của 聞く), đến thăm, ghé thăm (khiêm nhường của 行く、訪ねる)	TÝ
見つめる	みつめる	nhìn chằm chằm, nhìn chăm chú	KIẾN
詰め込む	つめこむ	nhất đầy vào, nhồi nhét	CẬT NHẬP
訪れる	おとずれる	đến thăm, ghé thăm; đến, tới (thời điểm, mùa, cảm xúc,...)	PHÓNG
収める	おさめる	cất giữ, cho vào (tủ, hộp); thu được, giành được	THU
処置	しょち	xử lý, biện pháp xử lý	XỨ TRÍ
処分	しょぶん	xử lý, vứt bỏ; xử phạt	XỨ PHÂN
対処	たいしょ	đối phó, xử lý	ĐỐI XỨ
誤解	ごかい	hiểu lầm, hiểu sai	NGỘ GIẢI
検討	けんとう	xem xét, cân nhắc	KIỂM THẢO
吸収	きゅうしゅう	hút, hấp thụ; tiếp thu	HẤP THU
収集	しゅうしゅう	thu thập, tập hợp; sưu tầm	THU TẬP
収穫	しゅうかく	thu hoạch, gặt hái	THU HOẠCH
予算	よさん	ngân sách, dự toán	DỰ TOÁN
依頼	いらい	yêu cầu, nhờ vả	Ỷ LẠI
渋滞	じゅうたい	tắc đường	SÁP TRỆ
対応	たいおう	ứng phó, xử lý	ĐỐI ỨNG
変化	へんか	thay đổi	BIẾN HÓA
発売	はつばい	bán ra, phát hành	PHÁT MẠI
受講	じゅこう	tham gia khóa học, tham dự lớp học	THỤ GIẢNG
計算	けいさん	tính toán, phép tính	KẾ TOÁN
記録	きろく	kỷ lục; ghi chép	KÝ LỤC
研修	けんしゅう	đào tạo, huấn luyện (ngắn hạn)	NGHIÊN TU
下降	かこう	giảm xuống, hạ xuống	HẠ HÀNG
違反	いはん	vi phạm	VI PHẢN
企画	きかく	kế hoạch	XÍ HỌA
処理	しょり	xử lý, giải quyết	XỨ LÝ
密閉	みっぺい	bịt kín, đóng kín	MẬT BẾ
求人	きゅうじん	tuyển dụng	CẦU NHÂN
願望	がんぼう	nguyện vọng, mong muốn	NGUYỆN VỌNG
完結	かんけつ	kết thúc, hoàn tất	HOÀN KẾT
油断	ゆだん	lơ là, chủ quan	DU ĐOẠN
評論	ひょうろん	bình luận, nhận xét, phê bình	BÌNH LUẬN
批評	ひひょう	phê bình, nhận xét, bình phẩm	PHÊ BÌNH
〜団	〜だん	hậu tố chỉ đoàn thể có tổ chức	ĐOÀN
保険	ほけん	bảo hiểm	BẢO HIỂM
仏教	ぶっきょう	Phật giáo	PHẬT GIÁO
硬貨	こうか	tiền xu	NGẠNH HÓA
運賃	うんちん	cước phí vận chuyển	VẬN NHẪM
貴重品	きちょうひん	đồ quý, đồ có giá trị	QUÝ TRỌNG PHẨM
賞金	しょうきん	tiền thưởng	THƯỞNG KIM
損	そん	lỗ, thiệt	TỔN
損得	そんとく	việc lỗ lãi, được mất	TỔN ĐẮC
損失	そんしつ	tổn thất, thiệt hại	TỔN THẤT
使い捨て	つかいすて	dùng một lần rồi bỏ	SỬ XẢ
周辺	しゅうへん	xung quanh	CHU BIÊN
株	かぶ	cổ phiếu, cổ phần; gốc (cây, rau củ)	CHU
賞味期限	しょうみきげん	hạn sử dụng	THƯỞNG VỊ KỲ HẠN
保護者	ほごしゃ	người giám hộ	BẢO HỘ GIẢ
当日	とうじつ	ngày đó, ngày hôm đó	ĐƯƠNG NHẬT
役割	やくわり	vai trò	DỊCH CÁT
講師	こうし	giảng viên	GIẢNG SƯ
極端	きょくたん	cực đoan, quá mức	CỰC ĐOAN
世の中	よのなか	thế gian, xã hội	THẾ TRUNG
豊富	ほうふ	phong phú, dồi dào	PHONG PHÚ
垂直	すいちょく	thẳng đứng, vuông góc	THÙY TRỰC
一色	いっしょく	một màu; toàn là, chỉ toàn là ~	NHẤT SẮC
プレッシャー		áp lực	pressure
バランス		sự cân bằng	balance
ダメージ		thiệt hại, hư hại	damage
原稿	げんこう	bản thảo	NGUYÊN CẢO
鮮明	せんめい	rõ ràng, sắc nét	TIÊN MINH
順調	じゅんちょう	thuận lợi	THUẬN ĐIỀU
等しい	ひとしい	bằng nhau, giống nhau	ĐẲNG
真新しい	まあたらしい	mới toanh, hoàn toàn mới	CHÂN TÂN
喧しい	やかましい	ồn ào, ầm ĩ, phiền hà	HUYÊN
ありがたい		biết ơn, cảm kích	
貴重	きちょう	quý giá	QUÝ TRỌNG
貧乏	びんぼう	sự nghèo khổ	BẦN PHẠP
貧困	ひんこん	nghèo đói, túng thiếu	BẦN KHỐN
密接	みっせつ	mật thiết, gần gũi	MẬT TIẾP
あいまい		mơ hồ, không rõ ràng	
至急	しきゅう	hỏa tốc, ngay lập tức	CHÍ CẤP
伴う	ともなう	đi cùng, cùng với, kèm theo, kéo theo	BẠN
切り捨てる	きりすてる	cắt bỏ, vứt bỏ; làm tròn xuống (số)	THIẾT XẢ
投げ捨てる	なげすてる	ném đi, vứt đi	ĐẦU XẢ
担う	になう	gánh vác (vai trò, trách nhiệm)	ĐẢM
担ぐ	かつぐ	khiêng, vác; tin vào	ĐẢM
引き受ける	ひきうける	nhận làm, đảm nhận	DẪN THỤ
耐える	たえる	chịu đựng, nhẫn nại	NẠI
漏らす	もらす	làm rò rỉ, làm lộ ra (nước, thông tin, bí mật,...);	LẬU
恵まれる	めぐまれる	được ban cho, được trời phú cho, may mắn có được	HUỆ
逆らう	さからう	phản đối, không tuân theo, ngược	NGHỊCH
努める	つとめる	nỗ lực, cố gắng	NỖ
責める	せめる	trách móc, khiển trách, đổ lỗi	TRÁCH
果たす	はたす	hoàn thành, thực hiện (nghĩa vụ, trách nhiệm,...)	QUẢ
敗れる	やぶれる	bị thua, bại trận	BẠI
備える	そなえる	chuẩn bị, trang bị/ có	BỊ
略す	りゃくす	lược bỏ, rút gọn	LƯỢC
属する	ぞくする	thuộc về	CHÚC
散らかる	ちらかる	bừa bộn, lung tung, lộn xộn	TÁN
もてなす		chiêu đãi, tiếp đãi	
賃貸	ちんたい	cho thuê	NHẪM THẢI
貿易	ぼうえき	thương mại, mậu dịch	MẬU DỊCH
受賞	じゅしょう	nhận giải thưởng, được trao thưởng	THỤ THƯỞNG
鑑賞	かんしょう	thưởng thức	GIÁM THƯỞNG
損害	そんがい	thiệt hại, hư hại	TỔN HẠI
担任	たんにん	giáo viên chủ nhiệm	ĐAM NHIỆM
拍手	はくしゅ	tràng pháo tay	PHÁCH THỦ
撮影	さつえい	quay phim, chụp ảnh	TOÁT ẢNH
保証	ほしょう	bảo hành, đảm bảo	BẢO CHỨNG
同意	どうい	đồng ý	ĐỒNG Ý
変更	へんこう	thay đổi	BIẾN CANH
返品	へんぴん	trả hàng	PHẢN PHẨM
圧勝	あっしょう	thắng áp đảo	ÁP THẮNG
接続	せつぞく	kết nối	TIẾP TỤC
逃亡	とうぼう	bỏ trốn, chạy trốn	ĐÀO VONG
要求	ようきゅう	yêu cầu	YẾU CẦU
登録	とうろく	đăng ký	ĐĂNG LỤC
尊重	そんちょう	tôn trọng	TÔN TRỌNG
出世	しゅっせ	thăng tiến	XUẤT THẾ
討論	とうろん	thảo luận, tranh luận	THẢO LUẬN
栽培	さいばい	trồng trọt, canh tác	TÀI BỒI
相違	そうい	sự khác biệt, khác nhau	TƯƠNG VI
解消	かいしょう	xóa bỏ, giải quyết	GIẢI TIÊU
〜賞	〜しょう	giải thưởng, thưởng cho một thành tích nào đó	THƯỞNG
貴〜	き〜	quý ~	QUÝ
〜賃	〜ちん	phí, tiền phải trả	NHẪM
〜代	〜だい	phí, chi phí	ĐẠI
〜費	〜ひ	phí, chi phí	PHÍ
〜料	〜りょう	phí, chi phí	LIỆU
技	わざ	kỹ năng, kỹ thuật	KỸ
特技	とくぎ	sở trường, kỹ năng đặc biệt, tài lẻ	ĐẶC KỸ
名演技	めいえんぎ	màn diễn xuất tuyệt vời, màn trình diễn xuất sắc	DANH DIỄN KỸ
競技場	きょうぎじょう	sân thi đấu, sân vận động	CẠNH KỸ TRƯỜNG
抗体	こうたい	kháng thể	KHÁNG THỂ
対抗心	たいこうしん	tinh thần cạnh tranh, tâm lý ganh đua	ĐỐI KHÁNG TÂM
色彩	しきさい	màu sắc, sắc thái	SẮC THẢI
乳製品	にゅうせいひん	sản phẩm từ sữa	NHŨ CHẾ PHẨM
礼	れい	lời cảm ơn, quà cảm ơn, cúi chào	LỄ
総選挙	そうせんきょ	tổng tuyển cử	TỔNG TUYỂN CỬ
天候	てんこう	thời tiết	THIÊN HẬU
講座	こうざ	khóa học, lớp học	GIẢNG TỌA
金額	きんがく	số tiền, khoản tiền	KIM NGẠCH
性別	せいべつ	giới tính	TÍNH BIỆT
植物	しょくぶつ	thực vật	THỰC VẬT
有無	うむ	có hay không	HỮU VÔ
国籍	こくせき	quốc tịch	QUỐC TỊCH
一律	いちりつ	đồng loạt, đồng đều, không phân biệt	NHẤT LUẬT
品質	ひんしつ	chất lượng	PHẨM CHẤT
素材	そざい	nguyên liệu, chất liệu	TỐ TÀI
食材	しょくざい	nguyên liệu nấu ăn	THỰC TÀI
本音	ほんね	lời nói thật lòng, suy nghĩ thật sự	BẢN ÂM
暴力	ぼうりょく	bạo lực	BẠO LỰC
規律	きりつ	quy tắc; kỷ luật, quy luật	QUY LUẬT
題名	だいめい	tựa đề, tiêu đề	ĐỀ DANH
コンプレックス		tự ti, mặc cảm	complex
多彩	たさい	đa dạng, nhiều màu sắc, phong phú	ĐA THẢI
乱暴	らんぼう	thô bạo, hung dữ, bạo lực	LOẠN BẠO
慎重	しんちょう	cẩn thận, cẩn trọng	THẬN TRỌNG
公平	こうへい	công bằng	CÔNG BÌNH
器用	きよう	khéo léo, khéo tay	KHÍ DỤNG
過剰	かじょう	quá mức, dư thừa	QUÁ THẶNG
無力	むりょく	bất lực, không có sức lực, không có khả năng	VÔ LỰC
拒む	こばむ	từ chối, khước từ	CỰ
言い換える	いいかえる	nói cách khác, diễn đạt lại	NGÔN HOÁN
乱す	みだす	làm xáo trộn, làm rối loạn, phá vỡ trật tự	LOẠN
乱れる	みだれる	bị rối loạn, bị xáo trộn	LOẠN
撃つ	うつ	bắn	KÍCH
整う	ととのう	đã sẵn sàng, được chuẩn bị	CHỈNH
おだてる		tâng bốc, xu nịnh	
偏る	かたよる	lệch về một phía, không cân bằng	THIÊN
呼び止める	よびとめる	gọi lại, gọi để dừng lại	HÔ CHỈ
張り切る	はりきる	hăng hái, hết mình, nhiệt tình	TRƯƠNG THIẾT
競技	きょうぎ	thi đấu, trận đấu thể thao	CẠNH KỸ
反抗	はんこう	chống đối, phản kháng, chống lại	PHẢN KHÁNG
対抗	たいこう	đối đầu, cạnh tranh	ĐỐI KHÁNG
抵抗	ていこう	đề kháng, kháng cự	ĐỀ KHÁNG
拝見	はいけん	xem, nhìn (khiêm nhường của 見る)	BÁI KIẾN
拡充	かくじゅう	mở rộng và tăng cường	KHUẾCH SUNG
拡張	かくちょう	mở rộng	KHUẾCH TRƯƠNG
拒否	きょひ	từ chối	CỰ PHỦ
逮捕	たいほ	bắt giữ, bắt (ai đó)	ĐÃI BỘ
換気	かんき	thông gió, lưu thông không khí	HOÁN KHÍ
交換	こうかん	trao đổi	GIAO HOÁN
転換	てんかん	chuyển đổi, thay đổi	CHUYỂN HOÁN
変換	へんかん	chuyển đổi, thay đổi (dữ liệu, ký tự)	BIẾN HOÁN
換算	かんさん	chuyển đổi (đơn vị, tiền tệ)	HOÁN TOÁN
声援	せいえん	cổ vũ, reo hò động viên	THANH VIỆN
支援	しえん	hỗ trợ, giúp đỡ, viện trợ	CHI VIỆN
援助	えんじょ	viện trợ, hỗ trợ, giúp đỡ	VIỆN TRỢ
採集	さいしゅう	thu thập, sưu tầm (mẫu vật, côn trùng...)	THẢI TẬP
採用	さいよう	tuyển dụng (người); chấp nhận và áp dụng (ý kiến, phương pháp)	THẢI DỤNG
仮採用	かりさいよう	tuyển dụng thử việc	GIẢ THẢI DỤNG
混乱	こんらん	hỗn độn, hỗn loạn, lộn xộn	HỖN LOẠN
攻撃	こうげき	tấn công, công kích	CÔNG KÍCH
選挙	せんきょ	bầu cử	TUYỂN CỬ
工夫	くふう	sáng tạo, khéo léo, cải tiến	CÔNG PHU
開発	かいはつ	phát triển	KHAI PHÁT
指導	しどう	hướng dẫn, chỉ đạo, dạy bảo	CHỈ ĐẠO
調理	ちょうり	nấu ăn, chế biến (thực phẩm)	ĐIỀU LÝ
捜査	そうさ	điều tra	SƯU TRA
注目	ちゅうもく	chú ý, quan tâm đặc biệt	CHÚ MỤC
着用	ちゃくよう	đeo, mặc	TRỨ DỤNG
消除	しょうじょ	loại bỏ, xóa bỏ	TIÊU TRỪ
導入	どうにゅう	đưa vào, áp dụng	ĐẠO NHẬP
交渉	こうしょう	thương lượng, đàm phán	GIAO THIỆP
決意	けつい	quyết tâm	QUYẾT Ý
逃避	とうひ	trốn tránh, lẩn tránh	ĐÀO TỊ
左右	さゆう	trái phải/ ảnh hưởng, chi phối	TẢ HỮU
改めて	あらためて	một lần nữa, lại	CẢI
徐々	じょじょ	dần dần, từ từ	TỪ
くるくる		xoay vòng vòng, cuộn tròn liên tục	
細々と	ほそぼそと	nhỏ lẻ, cầm chừng	TẾ
細々と	こまごまと	lặt vặt, vụn vặt	TẾ
丘	おか	Đồi, gò đất	KHÂU
兵士	へいし	Binh sĩ, người lính	BINH SĨ
兵器	へいき	Vũ khí	BINH KHÍ
浜	はま	Bãi biển, bờ biển	BÃI
沖	おき	Khơi, ngoài khơi	TRÙNG
河川	かせん	Sông ngòi	HÀ XUYÊN
沼	ぬま	Đầm lầy	CHIỂU
沼地	ぬまち	Vùng đầm lầy	CHIỂU ĐỊA
溶岩	ようがん	Dung nham	DUNG NHAM
汁	しる	Nước cốt, nước súp	TRẤP
漁業	ぎょぎょう	Ngành ngư nghiệp, nghề cá	NGƯ NGHIỆP
漁師	りょうし	Ngư dân	NGƯ SƯ
渡り鳥	わたりどり	Chim di cư	ĐỘ ĐIỂU
湿気	しっけ	Hơi ẩm	THẤP KHÍ
湿度	しつど	Độ ẩm	THẤP ĐỘ
苦痛	くつう	Đau đớn, nỗi khổ	KHỔ THỐNG
一流	いちりゅう	Hàng đầu, đứng đầu, cao cấp nhất	NHẤT LƯU
夜景	やけい	Cảnh đêm	DẠ CẢNH
熱中症	ねっちゅうしょう	Say nắng	NHIỆT TRUNG CHỨNG
進路	しんろ	Con đường, hướng đi	TIẾN LỘ
家計	かけい	Tài chính gia đình	GIA KÊ
釘	くぎ	Cái đinh	ĐINH
タイミング		Thời điểm	timing
物体	ぶったい	Vật thể	VẬT THỂ
テクニック		Kỹ thuật	technique
フラッシュ		Đèn flash; chỉ 1 khoảng thời gian ngắn	flash
憧れ	あこがれ	Mơ ước, khát khao, ao ước	SUNG
多難	たなん	Nhiều khó khăn, trắc trở	ĐA NẠN
マイペース		theo nhịp độ/ phương thức cá nhân	my pace
アポイントメント		Cuộc hẹn	appointment
活気	かっき	Sôi động, tràn đầy sức sống	HOẠT KHÍ
バイキング		Buffet (ăn tự chọn)	Viking
実地	じっち	Thực địa; thực tế	THỰC ĐỊA
ツアー		Tour du lịch, chuyến tham quan	tour
レギュラー		đều đặn, thường xuyên, thông thường	regular
ハード		khó khăn, khắc nghiệt	hard
スタンプ		Con dấu, tem, sticker	stamp
セールス		Bán hàng, tiếp thị	sales
ゼミ		Lớp chuyên đề, nhóm nghiên cứu nhỏ	(thường là nhóm nhỏ sinh viên dưới sự hướng dẫn của một giáo sư ở trường đại học)
ターゲット		Mục tiêu, đối tượng nhắm đến	target
タイマー		Đồng hồ hẹn giờ	timer
清い	きよい	Trong sạch, tinh khiết, trong lành	THANH
たくましい		Vạm vỡ, mạnh mẽ, kiên cường; sức sống tràn đầy, đầy nhiệt huyết	
輝かしい	かがやかしい	Rực rỡ, chói sáng, huy hoàng	HUY
清潔	せいけつ	Sạch sẽ, thanh khiết	THANH KHIẾT
微か	かすか	Rất nhỏ, mờ nhạt; mỏng manh, yếu ớt, chật vật	VI
気軽	きがる	Thoải mái, dễ dàng, dễ chịu	KHÍ KHINH
溶ける	とける	Tan ra, tan chảy	DUNG
溶け込む	とけこむ	Hòa nhập, hòa tan vào	DUNG NHẬP
沈む	しずむ	Chìm, lặn, bị lún xuống	TRẦM
浮かべる	うかべる	Làm nổi; biểu lộ; gợi nhớ, nhớ lại	PHÙ
浮かぶ	うかぶ	Nổi; xuất hiện, hiện lên	PHÙ
思い浮かぶ	おもいうかぶ	Nhớ ra, nghĩ tới	TƯ PHÙ
見渡す	みわたす	Nhìn bao quát, nhìn quanh	KIẾN ĐỘ
湿る	しめる	Bị ẩm, ẩm ướt	THẤP
眺める	ながめる	Ngắm nhìn	THIẾU
支える	ささえる	Đỡ, chống đỡ; giữ, duy trì; hỗ trợ, giúp đỡ	CHI
問い合わせる	といあわせる	Hỏi đáp, tư vấn	VẤN HỢP
得る	える	Đạt được, nhận được, có được	ĐẮC
縮む	ちぢむ	Bị co lại, thu nhỏ lại, rút ngắn	SÚC
改訂	かいてい	Sửa đổi, chỉnh sửa	CẢI ĐÍNH
決定	けってい	Quyết định	QUYẾT ĐỊNH
点検	てんけん	Kiểm tra	ĐIỂM KIỂM
中継	ちゅうけい	Phát sóng trực tiếp, truyền hình trực tiếp	TRUNG KẾ
保存	ほぞん	Bảo quản	BẢO TỒN
直行	ちょっこう	Đi thẳng, không dừng lại	TRỰC HÀNH
限定	げんてい	Giới hạn, hạn chế	HẠN ĐỊNH
合図	あいず	Ám hiệu, tín hiệu	HỢP ĐỒ
清掃	せいそう	Dọn dẹp, vệ sinh	THANH TẢO
清算	せいさん	Thanh toán, thanh lý	THANH TOÁN
退屈	たいくつ	Chán, nhàm chán, buồn tẻ	THOÁI KHUẤT
監督	かんとく	Giám sát; đạo diễn, huấn luyện viên	GIÁM ĐỐC
同情	どうじょう	cảm thông, đồng cảm	ĐỒNG TÌNH
アレンジ		Sắp xếp, tổ chức; chỉnh sửa, phối khí lại	arrange
アピール		Kêu gọi, thu hút sự chú ý, gây ấn tượng	appeal
チェンジ		Đổi, thay đổi	change
スリップ		Trượt, sự trượt chân, trượt ngã	slip
未だに	いまだに	Vẫn chưa, cho đến bây giờ vẫn ...	VỊ
続々と	ぞくぞくと	liên tục	TỤC
にっこり		Cười mỉm, cười tươi	
いらいら		Nóng ruột, khó chịu	
遅くとも	おそくとも	Muộn nhất là ~, trễ nhất là ~	TRÌ
予め	あらかじめ	Trước, chuẩn bị trước	DỰ
栄養	えいよう	Dinh dưỡng	VINH DƯỠNG
条件	じょうけん	Điều kiện	ĐIỀU KIỆN
悪条件	あくじょうけん	Điều kiện xấu, hoàn cảnh bất lợi	ÁC ĐIỀU KIỆN
杉	すぎ	Cây liễu sam	SAM
柄	がら	phẩm vị, tính cách; họa tiết, hoa văn	BÍNH
人柄	ひとがら	Tính cách, phẩm hạnh	NHÂN BÍNH
棒	ぼう	Cây gậy	BỔNG
材質	ざいしつ	Chất liệu, tính chất	TÀI CHẤT
柱	はしら	Cột, trụ	TRỤ
模様	もよう	Hoa văn, họa tiết;tình hình, trạng thái (diễn biến, tiến triển)	MÔ DẠNG
歩道橋	ほどうきょう	Cầu vượt dành cho người đi bộ	BỘ ĐẠO KIỀU
南極	なんきょく	Nam Cực	NAM CỰC
核心	かくしん	Trọng tâm, cốt lõi	HẠCH TÂM
景気	けいき	Tình hình kinh tế	CẢNH KHÍ
病状	びょうじょう	Triệu chứng, tình trạng bệnh	BỆNH TRẠNG
体格	たいかく	Thân hình, vóc dáng	THỂ CÁCH
視野	しや	Tầm ngắm, tầm nhìn	THỊ DÃ
格好	かっこう	Dáng vẻ, vẻ ngoài, cách ăn mặc	CÁCH HẢO
一気に	いっき	Một hơi, liền một mạch	NHẤT KHÍ
外見	がいけん	Bề ngoài, vẻ ngoài, diện mạo	NGOẠI KIẾN
ライバル		Đối thủ, người cạnh tranh	rival
ライフスタイル		Phong cách sống, lối sống	lifestyle
ギャップ		khoảng cách; chênh lệch, sự khác biệt	gap
規則	きそく	Quy định, quy tắc	QUY TẮC
代理	だいり	Đại diện	ĐẠI LÍ
複数	ふくすう	Nhiều, số nhiều	PHỨC SỐ
不景気	ふけいき	Suy thoái kinh tế, làm ăn ế ẩm; (gương mặt) ủ rũ	BẤT CẢNH KHÍ
ソフト		Phần mềm; mềm mại, nhẹ nhàng, soft	
多大	ただい	To lớn, rất nhiều	ĐA ĐẠI
幼い	おさない	Non nớt, bé, ngây thơ	ẤU
痛ましい	いたましい	Đau lòng, thương tâm	THỐNG
緩い	ゆるい	Lỏng, rộng; độ nghiêng nhẹ, (dốc) nhẹ, thoai thoải	HOÃN
まれ		Hiếm khi, hiếm có	
消極的	しょうきょくてき	Tiêu cực	TIÊU CỰC ĐÍCH
積極的	せっきょくてき	Tích cực	TÍCH CỰC ĐÍCH
なだらか		Thoai thoải	
枯れる	かれる	Bị héo, bị tàn	KHÔ
枯らす	からす	Làm héo	KHÔ
目指す	めざす	Nhắm tới, hướng tới (mục tiêu lớn)	MỤC CHỈ
尽きない	つきない	Không dứt, không hết	TẪN
面する	めんする	Hướng ra, giáp mặt, đối diện	DIỆN
関わり合う	かかわりあう	Có liên hệ với nhau, liên quan qua lại	QUAN HỢP
合わせる	あわせる	Cùng ~, cùng nhau; điều chỉnh cho phù hợp	HỢP
欠く	かく	Thiếu, khuyết	KHIẾM
飛び散る	とびちる	Bắn tung tóe, bay tứ tung	PHI TÁN
駆け込む	かけこむ	Chạy lao vào	KHU
触れ合う	ふれあう	Chạm, tiếp xúc; giao lưu, kết nối	XÚC HỢP
引っかかる	ひっかかる	Bị vướng, mắc vào, bị lừa, mắc bẫy	DẪN
頷く	うなずく	Gật đầu	HẠM
飛びつく	とびつく	Nhảy vào, vồ lấy	PHI
進出	しんしゅつ	Tiến vào, thâm nhập vào	TIẾN XUẤT
リハーサル		Diễn tập, tổng duyệt (trước sự kiện)	rehearsal
改正	かいせい	Sự thay đổi; chỉnh sửa	CẢI CHÁNH
特定	とくてい	Chỉ định đặc biệt, xác định rõ	ĐẶC ĐỊNH
通信	つうしん	Truyền thông, liên lạc	THÔNG TÍN
続出	ぞくしゅつ	Liên tục, liên tiếp xảy ra	TỤC XUẤT
開設	かいせつ	Mở mới, thành lập	KHAI THIẾT
指定	してい	Chỉ định	CHỈ ĐỊNH
失望	しつぼう	Thất vọng	THẤT VỌNG
対比	たいひ	So sánh; đối lập	ĐỐI BỈ
充満	じゅうまん	Tràn ngập, đầy (khói, mùi, khí,...)	SUNG MÃN
先着	せんちゃく	Đến trước	TIÊN TRƯỚC
納得	なっとく	thấu hiểu, bị thuyết phục, tiếp thu	NẠP ĐẮC
信用	しんよう	tin tưởng, tín nhiệm	TÍN DỤNG
発言	はつげん	Phát ngôn, lời nói	PHÁT NGÔN
記憶	きおく	ký ức, trí nhớ, ghi nhớ	KÍ ỨC
意識	いしき	ý thức, nhận thức	Ý THỨC
寄付	きふ	quyên góp	KÍ PHÓ
提案	ていあん	Đề xuất; đề án	ĐỀ ÁN
移動	いどう	di chuyển	DI ĐỘNG
スムーズに		Một cách trơn tru, suôn sẻ, trôi chảy	smooth
ぼんやり		Lờ mờ, mờ ảo, không rõ ràng; Mơ màng, không tập trung	
どろどろ		Nhão, sền sệt, lầy lội, dính đầy bùn	
一斉	いっせい	Đồng loạt, cùng lúc	NHẤT TỀ
ふさふさ		Rậm rạp (tóc, lông, cây cối)	
べたべた		(Dính) nhớp nháp, nhầy nhụa; dính nhau, quấn quýt	
どしどし		Không do dự, không ngại ngần, dồn dập, tới tấp	
何分	なにぶん	Dù sao đi nữa, mong được thông cảm	HÀ PHÂN
〜明け	〜あけ	Kết thúc một mùa, thời kỳ nào đó	MINH
幼稚	ようち	Trẻ con; non nớt, ấu trĩ	ẤU TRĨ
率直	そっちょく	Thẳng thắn, bộc trực	SUẤT TRỰC
確率	かくりつ	Xác suất	XÁC SUẤT
能率	のうりつ	Năng suất	NĂNG SUẤT
系統	けいとう	Hệ thống; dòng dõi; cùng loại/ tông/ kiểu...	HỆ THỐNG
子孫	しそん	Con cháu	TỬ TÔN
短編	たんぺん	Truyện ngắn, phim ngắn	ĐOẢN BIÊN
口紅	くちべに	Son môi	KHẨU HỒNG
納期	のうき	Hạn giao hàng (hoặc tiền thuế)	NẠP KỲ
絶好調	ぜっこうちょう	Tình trạng, trạng thái cực kỳ tốt, phong độ đỉnh cao	TUYỆT HẢO ĐIỀU
素人	しろうと	Nghiệp dư	TỐ NHÂN
酸素	さんそ	Khí oxy (O₂)	TOAN TỐ
素質	そしつ	Tố chất, năng khiếu bẩm sinh	TỐ CHẤT
質素	しっそ	Giản dị, mộc mạc, đơn giản (lối sống, ăn uống, trang phục...)	CHẤT TỐ
素直	すなお	Chân thành, thành thật, ngoan	TỐ TRỰC
素朴	そぼく	Mộc mạc, đơn giản (tính cách, câu hỏi...)	TỐ PHÁC
公害	こうがい	Ô nhiễm môi trường do con người gây ra	CÔNG HẠI
災害	さいがい	Thảm họa	TAI HẠI
毒	どく	Độc, chất độc, độc tố	ĐỘC
服装	ふくそう	Quần áo, trang phục	PHỤC TRANG
不器用	ぶきよう	Vụng về, không khéo léo	BẤT KHÍ DỤNG
プロ		Chuyên nghiệp	professional
画面	がめん	Màn hình	HỌA DIỆN
契機	けいき	Cơ hội, dịp	KHẾ CƠ
テンポ		Nhịp độ (âm nhạc, công việc...)	tempo
日中	にっちゅう	Ban ngày	NHẬT TRUNG
敏感	びんかん	Nhạy cảm, nhạy bén	MẪN CẢM
適度	てきど	Thích hợp, vừa phải	THÍCH ĐỘ
意欲	いよく	Ý chí, sự khát khao	Ý DỤC
ふさわしい		Phù hợp, tương thích	
うっとうしい		U ám, nặng nề; phiền phức, chán nản, khó chịu	
単純	たんじゅん	Đơn giản, đơn thuần	ĐƠN THUẦN
純粋	じゅんすい	Trong sáng, tinh khiết	THUẦN TÚY
機敏	きびん	Nhanh nhạy, lanh lợi, linh hoạt	CƠ MẪN
頑丈	がんじょう	Chắc chắn, vững chắc, kiên cố	NGOAN TRƯỢNG
物騒	ぶっそう	Nguy hiểm, bất an	VẬT TAO
奇妙	きみょう	Kỳ lạ, kỳ dị	KÌ DIỆU
妙	みょう	Lạ thường	DIỆU
編む	あむ	Đan	BIÊN
縮れる	ちぢれる	Nhăn lại, co lại; quăn, xoăn	SÚC
納める	おさめる	Nộp (tiền, thuế), giao (hàng); cất, để vào; kết thúc, hoàn thành (công việc, hành động)	NẠP
絡まる	からまる	Bị vướng, rối vào;	LẠC
稼ぐ	かせぐ	Kiếm tiền; câu giờ	GIÁ
生まれ育つ	うまれそだつ	Sinh ra và lớn lên	SINH DỤC
引き止める	ひきとめる	Níu chân, giữ/ kéo lại, ngăn lại	DẪN CHỈ
買い占める	かいしめる	Mua vét, mua hết	MÃI CHIÊM
かなえる		Thành hiện thực	
結びつく	むすびつく	Kết hợp, kết nối, gắn liền	KẾT
纏める	まとめる	Thu gom, tập hợp; sắp xếp, tổ chức	TRIỀN
つまずく		Ngã, vấp ngã; thất bại	
くっつく		Dính chặt, bám chặt; theo sát	
編集	へんしゅう	Biên tập (sách, báo,...), chỉnh sửa (video)	BIÊN TẬP
圧縮	あっしゅく	Nén lại, ép lại;	ÁP SÚC
恐縮	きょうしゅく	Thật ngại, xin lỗi (vì đã làm phiền), cảm ơn (vì nhận được sự ưu ái)	KHỦNG SÚC
縮小	しゅくしょう	Thu nhỏ, co nhỏ, nén lại	SÚC TIỂU
短縮	たんしゅく	Rút ngắn	ĐOẢN SÚC
納税	のうぜい	Nộp thuế	NẠP THUẾ
継続	けいぞく	Tiếp tục, duy trì, tiếp nối	KẾ TỤC
管理	かんり	quản lý, điều hành, điều khiển	QUẢN LÝ
進学	しんがく	Học lên	TIẾN HỌC
挑戦	ちょうせん	Thử thách, thách thức	THIÊU CHIẾN
絶滅	ぜつめつ	Tuyệt chủng	TUYỆT DIỆT
催促	さいそく	Hối thúc, thúc giục	THÔI XÚC
発達	はったつ	Phát triển	PHÁT ĐẠT
展開	てんかい	Triển khai, phát triển, mở rộng	TRIỂN KHAI
応答	おうとう	Phản hồi, trả lời	ỨNG ĐÁP
機能	きのう	Chức năng, tính năng	CƠ NĂNG
回復	かいふく	Hồi phục	HỒI PHỤC
専念	せんねん	Tập trung, chuyên tâm	CHUYÊN NIỆM
絶えず	たえず	Liên tục, không ngừng	TUYỆT
きっぱり		Dứt khoát, thẳng thừng	
ごろごろ		Ngồi chơi, nằm không; lăn lông lốc;	
ゆらゆら		Lắc lư, đong đưa	
きょろきょろ		Nhìn quanh lo lắng, liếc mắt nhìn quanh tò mò, bối rối	
ただちに		Ngay lập tức, tức thì	
こそこそ		Lén lút, rón rén	
くたくた		Mệt mỏi rã rời, kiệt sức; cũ kỹ, cũ nát; mềm nhừ (thức ăn nấu quá lâu)	
〜主	〜ぬし	Chủ ~ (người sở hữu, người có liên quan đến ~)	CHỦ
〜先	〜さき	Nơi chốn đích đến, đối tượng (nơi, người nhận...)	TIÊN
〜手	〜て	Người ~ (chỉ người thực hiện hành động)	THỦ
〜師	〜し	Chỉ người có kiến thức hoặc kỹ năng chuyên môn cao trong một lĩnh vực nào đó	SƯ
〜率	〜りつ	Tỉ lệ ~	SUẤT
窓側	まどがわ	Phía cửa sổ	SONG TRẮC
窓際	まどぎわ	Sát cửa sổ, bên cửa sổ	SONG TẾ
総売上	そううりあげ	Tổng doanh thu	TỔNG MẠI THƯỢNG
恵み	めぐみ	Lộc, ân huệ	HUỆ
恩恵	おんけい	Ơn huệ, ân huệ, lợi ích	ÂN HUỆ
知恵	ちえ	Trí tuệ, sự khôn ngoan, thông thái	TRI HUỆ
優良	ゆうりょう	Ưu tú, chất lượng tốt, vượt trội	ƯU LƯƠNG
態度	たいど	Thái độ, cách cư xử	THÁI ĐỘ
密	みつ	Dày đặc, đầy kín; mật thiết, chặt chẽ; tỉ mỉ, chi tiết; bí mật, kín đáo	MẬT
秘密	ひみつ	Bí mật	BÍ MẬT
快晴	かいせい	Trời đẹp, trời quang mây	KHOÁI TÌNH
快速	かいそく	tàu nhanh	KHOÁI TỐC
快調	かいちょう	Thuận lợi, trơn tru, suôn sẻ	KHOÁI ĐIỀU
不快	ふかい	Khó chịu, bực bội	BẤT KHOÁI
不愉快	ふゆかい	Khó chịu, bực bội, không vui	BẤT DU KHOÁI
仮契約	かりけいやく	Hợp đồng tạm thời	GIẢ KHẾ ƯỚC
芸能人	げいのうじん	Nghệ sĩ	NGHỆ NĂNG NHÂN
要点	ようてん	Điểm quan trọng, ý chính	YẾU ĐIỂM
リラックス		Thư giãn	relax
お札	おさつ	Tiền giấy	TRÁT
お札	おふだ	Tấm bùa	TRÁT
改札	かいさつ	Cửa soát vé	CẢI TRÁT
会費	かいひ	Phí hội viên	HỘI PHÍ
器具	きぐ	Dụng cụ, thiết bị	KHÍ CỤ
気象	きしょう	Khí tượng.	KHÍ TƯỢNG
生地	きじ	Vải; bột làm bánh	SINH ĐỊA
北半球	きたはんきゅう	Bán cầu Bắc	BẮC BÁN CẦU
基地	きち	Căn cứ, cơ sở, nơi đóng quân hoặc nơi hoạt động của một tổ chức	CƠ ĐỊA
機長	きちょう	Cơ trưởng	CƠ TRƯỞNG
基盤	きばん	Nền tảng, cơ sở, nền móng	CƠ BÀN
急用	きゅうよう	Việc gấp	CẤP DỤNG
チューインガム		Kẹo cao su	chewing gum
リハビリ		Phục hồi chức năng	rehabilitation
リビング		Phòng khách, phòng sinh hoạt chung trong nhà	living (room)
リポーター		Phóng viên, người đưa tin	reporter
ロス		Mất mát, thiệt hại	loss
恐ろしい	おそろしい	Đáng sợ, khủng khiếp	KHỦNG
悔しい	くやしい	Cay cú, bực dọc; tiếc nuối	HỐI
心細い	こころぼそい	Bất an	TÂM TẾ
惜しい	おしい	Đáng tiếc, yêu quý, quý trọng	TÍCH
険しい	けわしい	Nghiêm khắc, hung dữ; hiểm trở	HIỂM
簡潔	かんけつ	Ngắn gọn, súc tích	GIẢN KHIẾT
不潔	ふけつ	Dơ bẩn, mất vệ sinh; tục tĩu, bẩn thỉu, đồi bại	BẤT KHIẾT
大型	おおがた	Lớn, kích thước lớn	ĐẠI HÌNH
優れる	すぐれる	Xuất sắc, ưu tú, giỏi, vượt trội	ƯU
恐れる	おそれる	Sợ, sợ hãi, lo sợ	KHỦNG
招く	まねく	Mời; gây ra, dẫn đến	CHIÊU
生まれ変わる	うまれかわる	Sinh ra lần nữa, đầu thai; thay đổi hoàn toàn	SINH BIẾN
寝過ごす	ねすごす	Ngủ quên, ngủ quá giờ	TẨM QUÁ
羨む	うらやむ	Đố kỵ, ghen tị	TIỆN
総合	そうごう	Tổng hợp	TỔNG HỢP
分析	ぶんせき	Phân tích	PHÂN TÍCH
総動員	そうどういん	Huy động toàn bộ	TỔNG ĐỘNG VIÊN
志願	しがん	Tình nguyện	CHÍ NGUYỆN
志望	しぼう	Nguyện vọng, mong muốn	CHÍ VỌNG
優勝	ゆうしょう	Vô địch, chiến thắng	ƯU THẮNG
準優勝	じゅんゆうしょう	Á quân, hạng nhì	CHUẨN ƯU THẮNG
優先	ゆうせん	Ưu tiên	ƯU TIÊN
最優先	さいゆうせん	Ưu tiên hàng đầu	TỐI ƯU TIÊN
恐怖	きょうふ	Nỗi sợ, sự sợ hãi, nỗi kinh hoàng	KHỦNG BỐ
共同	きょうどう	Cộng tác, hợp tác, làm việc chung	CỘNG ĐỒNG
後悔	こうかい	Hối hận	HẬU HỐI
喫煙	きつえん	Hút thuốc	KHIẾT YÊN
招待	しょうたい	Mời	CHIÊU ĐÃI
休息	きゅうそく	Nghỉ ngơi, thư giãn	HƯU TỨC
照明	しょうめい	Chiếu sáng, thiết bị chiếu sáng	CHIẾU MINH
対照	たいしょう	Sự đối chiếu; sự tương phản, trái ngược	ĐỐI CHIẾU
徹夜	てつや	Thức trắng đêm	TRIỆT DẠ
仮定	かてい	Giả định	GIẢ ĐỊNH
握手	あくしゅ	Bắt tay; làm hòa, hợp tác	ÁC THỦ
参照	さんしょう	Tham khảo	THAM CHIẾU
演説	えんぜつ	Diễn thuyết	DIỄN THUYẾT
軽傷	けいしょう	Thương nhẹ	KHINH THƯƠNG
親孝行	おやこうこう	Hiếu thảo, báo hiếu	THÂN HIẾU HÀNH
転倒	てんとう	Ngã, té; đảo lộn, đảo ngược	CHUYỂN ĐẢO
チャージ		Nạp (tiền,...), sự tính phí	charge
既に	すでに	Đã, rồi ...	KÝ
ひそひそ		Thì thầm, nói nhỏ, lén lút	
精一杯	せいいっぱい	Hết sức, toàn lực	TINH NHẤT BÔI
ぞろぞろ		Nối tiếp nhau, lũ lượt; lê thê, kéo lê	
元〜	もと〜	Trước đây, cũ, đã từng	NGUYÊN
前〜	ぜん〜	Trước, trước đây	TIỀN
現〜	げん〜	Hiện tại, hiện nay	HIỆN
格別	かくべつ	Đặc biệt, khác biệt	CÁCH BIỆT
別荘	べっそう	Biệt thự, nhà nghỉ dưỡng	BIỆT TRANG
逆差別	ぎゃくさべつ	Sự phân biệt đối xử ngược	NGHỊCH SAI BIỆT
演劇	えんげき	Vở kịch	DIỄN KỊCH
劇場	げきじょう	Nhà hát, rạp hát	KỊCH TRƯỜNG
劇場版	げきじょうばん	Phiên bản điện ảnh	KỊCH TRƯỜNG BẢN
彫刻	ちょうこく	Điêu khắc	ĐIÊU KHẮC
姿勢	しせい	Tư thế; thái độ	TƯ THẾ
容姿	ようし	Ngoại hình	DUNG TƯ
資格	しかく	Chứng chỉ; tư cách	TƯ CÁCH
資源	しげん	Tài nguyên	TƯ NGUYÊN
資本	しほん	Tiền vốn, vốn	TƯ BẢN
強盗	ごうとう	Cướp bóc; kẻ cướp	CƯỜNG ĐẠO
盗難	とうなん	Trộm cắp, mất cắp tài sản.	ĐẠO NẠN
欧米	おうべい	Âu Mỹ, phương Tây	ÂU MỄ
魚介類	ぎょかいるい	Hải sản	NGƯ GIỚI LOẠI
企業	きぎょう	Công ty, doanh nghiệp.	XÍ NGHIỆP
大企業	だいきぎょう	Doanh nghiệp lớn, công ty lớn (về quy mô)	ĐẠI XÍ NGHIỆP
大手企業	おおてきぎょう	Doanh nghiệp, công ty lớn hàng đầu (có tầm ảnh hưởng, vị thế cao)	ĐẠI THỦ XÍ NGHIỆP
本論	ほんろん	Phần chính, phần trọng tâm	BẢN LUẬN
理論	りろん	Lý thuyết	LÝ LUẬN
論文	ろんぶん	Bài luận văn	LUẬN VĂN
高齢化	こうれいか	Sự già hóa dân số	CAO LINH HÓA
要領	ようりょう	Cách thức, phương pháp, cách làm	YẾU LĨNH
領収書	りょうしゅうしょ	Hóa đơn, biên lai	LĨNH THU THƯ
額	がく	Số tiền, số lượng	NGẠCH
額	ひたい	Trán	NGẠCH
半額	はんがく	Nửa giá, giảm một nửa	BÁN NGẠCH
高額	こうがく	Số tiền lớn, giá cao	CAO NGẠCH
総額	そうがく	Tổng số tiền	TỔNG NGẠCH
児童	じどう	Nhi đồng, thiếu nhi	NHI ĐỒNG
幼児	ようじ	Trẻ nhỏ (trẻ em độ tuổi mẫu giáo)	ẤU NHI
兆	ちょう	Nghìn tỷ	TRIỆU
銃	じゅう	Súng	SÚNG
ゲスト		Khách mời	guest
罪	つみ	Tội, tội danh	TỘI
全般	ぜんぱん	Tổng quát, toàn diện, toàn bộ	TOÀN BAN
武器	ぶき	Vũ khí	VŨ KHÍ
対象	たいしょう	Đối tượng	ĐỐI TƯỢNG
悪意	あくい	Ác ý, ý định xấu	ÁC Ý
一体感	いったいかん	Cảm giác thống nhất, cảm giác hòa hợp	NHẤT THỂ CẢM
各地	かくち	Các địa phương, các vùng	CÁC ĐỊA
外科	げか	Ngoại khoa	NGOẠI KHOA
原料	げんりょう	Nguyên liệu	NGUYÊN LIỆU
作物	さくもつ	Hoa màu, nông sản	TÁC VẬT
支社	ししゃ	Chi nhánh	CHI XÃ
始発	しはつ	Chuyến tàu, chuyến xe bus đầu tiên trong ngày	THỦY PHÁT
芝生	しばふ	Cỏ, thảm cỏ, bãi cỏ	CHI SINH
時差	じさ	Chênh lệch múi giờ	THỜI SAI
万一	まんいち	Trường hợp bất trắc, tình huống bất ngờ	VẠN NHẤT
手前	てまえ	Trước mặt mình; phía gần mình; thể diện trước người khác	THỦ TIỀN
最寄り	もより	Gần nhất	TỐI KÍ
目印	めじるし	Dấu hiệu, ký hiệu; vật làm mốc, mục tiêu	MỤC ẤN
罰金	ばっきん	Tiền phạt	PHẠT KIM
値	ね	Giá trị, giá cả, số tiền	TRỊ
値引き	ねびき	Giảm giá, khuyến mãi	TRỊ DẪN
真剣	しんけん	Nghiêm túc, nghiêm trang	CHÂN KIẾM
頑固	がんこ	Bảo thủ, cứng đầu	NGOAN CỐ
論理的	ろんりてき	Logic, có lý luận	LUẬN LÝ ĐÍCH
刺す	さす	Đâm	THÍCH
盗む	ぬすむ	Ăn cắp, lấy trộm	ĐẠO
論じる	ろんじる	Thảo luận, tranh luận	LUẬN
心がける	こころがける	Cố gắng, chú tâm	TÂM
遡る	さかのぼる	Đi ngược dòng; quay về (quá khứ, nguồn gốc)	TỐ
差別	さべつ	Sự phân biệt, phân biệt đối xử	SAI BIỆT
選別	せんべつ	Sự tuyển chọn, chọn lọc, phân loại	TUYỂN BIỆT
分別	ぶんべつ	Phân loại	PHÂN BIỆT
介護	かいご	Chăm sóc, điều dưỡng	GIỚI HỘ
議論	ぎろん	Thảo luận, tranh luận, cuộc thảo luận	NGHỊ LUẬN
反論	はんろん	Phản bác, phản đối	PHẢN LUẬN
育児	いくじ	Việc nuôi dưỡng trẻ	DỤC NHI
充実	じゅうじつ	Sự đầy đủ, phong phú, viên mãn	SUNG THỰC
充電	じゅうでん	Sạc điện	SUNG ĐIỆN
統一	とういつ	Thống nhất	THỐNG NHẤT
交流	こうりゅう	Giao lưu	GIAO LƯU
接客	せっきゃく	Tiếp khách	TIẾP KHÁCH
減少	げんしょう	Sự giảm bớt, giảm đi	GIẢM THIỂU
別〜	べつ〜	~ khác, riêng, tách biệt	BIỆT
〜別	〜べつ	Theo ~, phân loại theo ~	BIỆT
悪〜	あく〜	~ xấu, có hại, tiêu cực	ÁC
〜連れ	〜づれ	Đi cùng với ~, dẫn theo ~	LIÊN
頂点	ちょうてん	Đỉnh; đỉnh cao, đỉnh điểm, đứng đầu, đứng top	ĐÍNH ĐIỂM
政党	せいとう	Đảng (chính trị)	CHÍNH ĐẢNG
野党	やとう	Đảng đối lập	DÃ ĐẢNG
与党	よとう	Đảng cầm quyền	DỮ ĐẢNG
競馬	けいば	Đua ngựa	CẠNH MÃ
競争心	きょうそうしん	Tinh thần cạnh tranh	CẠNH TRANH TÂM
宇宙	うちゅう	Vũ trụ	VŨ TRỤ
宝くじ	たからくじ	Vé số, xổ số	BẢO
宝石	ほうせき	Đá quý	BẢO THẠCH
宛先	あてさき	Địa chỉ nhận (thư từ, tài liệu)	UYỂN TIÊN
宗教	しゅうきょう	Tôn giáo	TÔN GIÁO
壁際	かべぎわ	Gần tường, cạnh tường	BÍCH TẾ
間際	まぎわ	Ngay trước khi, lúc sắp sửa	GIAN TẾ
寝際	ねぎわ	Lúc sắp ngủ, khi chuẩn bị đi ngủ.	TẨM TẾ
帰り際	かえりぎわ	Trước khi ra về, trước khi rời đi	QUI TẾ
別れ際	わかれぎわ	Lúc chia tay, thời điểm chia tay	BIỆT TẾ
投票率	とうひょうりつ	Tỷ lệ bỏ phiếu	ĐẦU PHIẾU SUẤT
目標	もくひょう	Mục tiêu	MỤC TIÊU
標準	ひょうじゅん	Tiêu chuẩn	TIÊU CHUẨN
不正	ふせい	Hành vi gian lận, bất chính, sai trái	BẤT CHÍNH
神様	かみさま	Thần, vị thần	THẦN DẠNG
立場	たちば	Lập trường; vị trí	LẬP TRƯỜNG
物事	ものごと	Mọi sự vật, sự việc	VẬT SỰ
一面	いちめん	Một mặt (của vật thể); một khía cạnh, một phương diện; toàn bộ khu vực, khắp xung quanh	NHẤT DIỆN
一瞬	いっしゅん	Chốc lát, khoảnh khắc, trong nháy mắt	NHẤT THUẤN
一般	いっぱん	Cái chung, thông thường	NHẤT BÀN
海辺	うみべ	Bờ biển	HẢI BIÊN
空間	くうかん	Không gian	KHÔNG GIAN
自体	じたい	Cơ thể của mình; chính bản thân, chính thể	TỰ THỂ
新入生	しんにゅうせい	Học sinh/ sinh viên mới	TÂN NHẬP SINH
気圧	きあつ	Áp suất không khí	KHÍ ÁP
運命	うんめい	Định mệnh, vận mệnh, số phận	VẬN MỆNH
意思	いし	Ý nghĩ, mong muốn	Ý TƯ
売れ行き	うれゆき	Tình trạng bán hàng, tiêu thụ hàng hóa	MẠI HÀNH
幸運	こううん	May mắn, vận may	HẠNH VẬN
霧	きり	Sương mù	VỤ
気力	きりょく	Sức mạnh tinh thần, động lực	KHÍ LỰC
金銭	きんせん	Tiền bạc	KIM TIỀN
行列	ぎょうれつ	Hàng người, xếp hàng	HÀNH LIỆT
仕組み	しくみ	Cơ cấu, cơ chế, cấu tạo	SĨ TỔ
試し	ためし	Sự thử nghiệm, thử làm	THÍ
単位	たんい	Đơn vị; tín chỉ	ĐƠN VỊ
第一印象	だいいちいんしょう	Ấn tượng đầu tiên	ĐỆ NHẤT ẤN TƯỢNG
大豆	だいず	Đậu nành	ĐẠI ĐẬU
地位	ちい	Địa vị, vị trí	ĐỊA VỊ
中世	ちゅうせい	Thời Trung Cổ	TRUNG THẾ
中立	ちゅうりつ	Sự trung lập	TRUNG LẬP
長官	ちょうかん	Người đứng đầu một cơ quan, tổ chức	TRƯỜNG QUAN
直線	ちょくせん	Đường thẳng	TRỰC TUYẾN
直径	ちょっけい	Đường kính	TRỰC KÍNH
通路	つうろ	Lối đi	THÔNG LỘ
モデル		Mẫu, đồ mẫu, người mẫu	
コンセント		Ổ cắm điện	
鋭い	するどい	Nhọn, sắc; sắc sảo	DUỆ
明らか	あきらか	Rõ ràng, hiển nhiên	MINH
バレバレ		Dễ nhận thấy, lộ liễu	
頂く	いただく	Nhận; ăn, uống (khiêm nhường ngữ)	ĐÍNH
競う	きそう	Cạnh tranh, thi đua	CẠNH
宛てる	あてる	Gửi	UYỂN
祭る	まつる	Thờ	TẾ
殴る	なぐる	Đấm	ẨU
好む	このむ	Yêu thích	HẢO
投票	とうひょう	Bỏ phiếu	ĐẦU PHIẾU
負担	ふたん	Gánh nặng; chịu (trách nhiệm, chi phí)	PHỤ ĐẢM
骨折	こっせつ	Gãy xương	CỐT CHIẾT
動揺	どうよう	Rung chuyển; dao động, hoang mang, lo lắng, bối rối	ĐỘNG DAO
安定	あんてい	ổn định	AN ĐỊNH
位置	いち	Vị trí	VỊ TRÍ
応用	おうよう	ứng dụng	ỨNG DỤNG
規定	きてい	Quy định, quy tắc	QUI ĐỊNH
覚悟	かくご	Xác định tinh thần	GIÁC NGỘ
確信	かくしん	Tin tưởng tuyệt đối	XÁC TÍN
意図	いと	Ý định	Ý ĐỒ
共用	きょうよう	Sử dụng chung	CỘNG DỤNG
頂戴	ちょうだい	(Khiêm nhường ngữ) Nhận; ăn, uống	ĐÍNH ĐÁO
直結	ちょっけつ	Kết nối trực tiếp, sự liên quan trực tiếp	TRỰC KẾT
通達	つうたつ	Thông tư, thông báo	THÔNG ĐẠT
通用	つうよう	Sử dụng phổ biến, thông dụng; công nhận, chấp nhận	THÔNG DỤNG
通話	つうわ	Cuộc gọi, gọi điện thoại	THÔNG THOẠI
堂々	どうどう	Đàng hoàng, tự tin	ĐƯỜNG ĐƯỜNG
〜元	〜もと	Nguồn gốc hoặc nơi xuất phát	NGUYÊN
名〜	めい〜	Danh tiếng, nổi tiếng	DANH
明確	めいかく	rõ ràng, minh bạch, chính xác	MINH XÁC
旧暦	きゅうれき	lịch âm	CỰU LỊCH
著者	ちょしゃ	tác giả	TRỨ GIẢ
著書	ちょしょ	tác phẩm	TRỨ THƯ
内緒	ないしょ	bí mật, chuyện riêng tư	NỘI TỰ
顕微鏡	けんびきょう	kính hiển vi	HIỂN VI KÍNH
望遠鏡	ぼうえんきょう	ống nhòm, kính viễn vọng	VỌNG VIỄN KÍNH
境	さかい	biên giới	CẢNH
国境	こっきょう	biên giới quốc gia	QUỐC CẢNH
心境	しんきょう	tâm trạng, tâm tư	TÂM CẢNH
境目	さかいめ	đường ranh giới, ranh giới	CẢNH MỤC
境界	きょうかい	ranh giới, giới hạn	CẢNH GIỚI
業界	ぎょうかい	ngành	NGHIỆP GIỚI
部署	ぶしょ	phòng ban, bộ phận, đơn vị (trong tổ chức, công ty)	BỘ THỰ
情景	じょうけい	cảnh tượng, khung cảnh	TÌNH CẢNH
背景	はいけい	bối cảnh, phông nền, hoàn cảnh	BỐI CẢNH
就職率	しゅうしょくりつ	tỷ lệ tìm được việc làm	TỰU CHỨC SUẤT
制度	せいど	chế độ, hệ thống, quy chế	CHẾ ĐỘ
看板	かんばん	biển hiệu, bảng hiệu	KHÁN BẢN
便り	たより	tin, tin tức, thư từ	TIỆN
様子	ようす	tình trạng, dáng vẻ, trạng thái	DẠNG TỬ
小麦	こむぎ	lúa mì	TIỂU MẠCH
物質	ぶっしつ	chất, vật chất	VẬT CHẤT
視覚	しかく	thị giác	THỊ GIÁC
結末	けつまつ	kết cục, kết thúc, phần kết	KẾT MẠT
項目	こうもく	mục, phần mục	HẠNG MỤC
業績	ぎょうせき	thành tích, thành tựu	NGHIỆP TÍCH
四角	しかく	hình vuông	TỨ GIÁC
座席	ざせき	chỗ ngồi, ghế ngồi	TỌA TỊCH
突き当たり	つきあたり	đoạn cuối, cuối đường	ĐỘT ĐƯƠNG
係員	かかりいん	người phụ trách, nhân viên	HỆ VIÊN
達成感	たっせいかん	cảm giác thành tựu, cảm giác đạt được	ĐẠT THÀNH CẢM
ストライキ		đình công, bãi công	strike
スポーツクラブ		câu lạc bộ thể thao	sports club
レッスン		bài học, buổi học	lesson
ストレート		thẳng; trực tiếp; thẳng thắn, straight	
著しい	いちじるしい	rõ rệt, đáng kể, nổi bật	TRỨ
優秀	ゆうしゅう	ưu tú, xuất sắc, giỏi	ƯU TÚ
定期的	ていきてき	định kỳ, thường kỳ, đều đặn	ĐỊNH KÌ ĐÍCH
スマート		thon gọn;thông minh	
就く	つく	đảm nhận, nhận; bắt đầu	TỰU
昇る	のぼる	lên, mọc lên	THĂNG
更ける	ふける	về khuya; (mùa) về cuối	CANH
凍る	こおる	đóng băng, đông lại, bị đông cứng	ĐÔNG
凍える	こごえる	lạnh cóng, bị đông cứng	ĐÔNG
乾く	かわく	khô, ráo	KIỀN
乾かす	かわかす	làm khô, phơi khô, sấy khô	KIỀN
響く	ひびく	vang, vọng, vọng lại	HƯỞNG
控える	ひかえる	kiềm chế, hạn chế; chờ, chờ đợi	KHỐNG
上昇	じょうしょう	sự tăng lên, sự lên cao, sự tiến lên	THƯỢNG THĂNG
急上昇	きゅうじょうしょう	sự tăng vọt, tăng nhanh	CẤP THƯỢNG THĂNG
更新	こうしん	cập nhật, làm mới; gia hạn	CANH TÂN
乾燥	かんそう	sự khô, khô ráo; làm khô	KIỀN TÁO
署名	しょめい	chữ ký, ký tên	THỰ DANH
組織	そしき	tổ chức	TỔ CHỨC
開催	かいさい	tổ chức (sự kiện, cuộc họp...)	KHAI THÔI
警備	けいび	bảo vệ, cảnh giới	CẢNH BỊ
提供	ていきょう	cung cấp; tài trợ	ĐỀ CUNG
関連	かんれん	mối quan hệ, liên quan	QUAN LIÊN
思考	しこう	suy nghĩ, tư duy	TƯ KHẢO
在学	ざいがく	đang theo học, đang học (ở trường, đại học)	TẠI HỌC
レンタル		thuê, cho thuê	rental
就任	しゅうにん	nhậm chức, nhận chức vụ	TỰU NHÂM
後ほど	のちほど	sau đây, lát nữa	HẬU
〜界	〜かい	dùng để chỉ một lĩnh vực, ngành nghề, hoặc cộng đồng nào đó.	GIỚI
〜旬	〜じゅん	10 ngày (1/3 của một tháng)	TUẦN
〜署	〜しょ	cơ quan, tổ chức, cơ sở hành chính liên quan đến chức năng cụ thể	THỰ
〜下	〜か	dưới sự kiểm soát, sự quản lý của một tổ chức hoặc một cá nhân nào đó.	HẠ
〜観	〜かん	quan điểm, cách nhìn nhận	QUAN
旧〜	きゅう〜	cũ, xưa, trước đây	CỰU
同僚	どうりょう	đồng nghiệp	ĐỒNG LIÊU
巣	す	tổ	SÀO
薄味	うすあじ	nhạt, vị nhạt	BẠC VỊ
高層	こうそう	tầng cao; cao tầng	CAO TẦNG
高層マンション		chung cư cao tầng	CAO TẦNG
差異	さい	sự khác biệt, sự khác nhau	SAI DỊ
異国	いこく	nước khác, quốc gia khác	DỊ QUỐC
異色	いしょく	khác biệt, độc đáo	DỊ SẮC
異文化	いぶんか	nền văn hóa khác nhau	DỊ VĂN HÓA
異分野	いぶんや	lĩnh vực khác, ngành nghề khác	DỊ PHÂN DÃ
畳	たたみ	chiếu tatami	ĐIỆP
簡略	かんりゃく	đơn giản hóa, ngắn gọn	GIẢN LƯỢC
必死	ひっし	quyết tâm, nỗ lực hết sức	TẤT TỬ
戦略	せんりゃく	chiến lược	CHIẾN LƯỢC
家畜	かちく	gia súc	GIA SÚC
遺産	いさん	di sản; tài sản thừa kế	DI SẢN
明かり	あかり	ánh sáng, ánh đèn	MINH
区切り	くぎり	sự ngắt đoạn, điểm dừng	KHU THIẾT
鎖	くさり	xích, dây xích	TỎA
唇	くちびる	môi	THẦN
苦難	くなん	khó khăn, gian khổ, thử thách	KHỔ NAN
組	くみ	nhóm, tổ; một bộ (set)	TỔ
組み合わせ	くみあわせ	sự kết hợp, sự phối hợp	TỔ HỢP
暗闇	くらやみ	bóng tối	ÁM ÁM
黒字	くろじ	lãi, lợi nhuận	HẮC TỰ
形式	けいしき	hình thức, định dạng	HÌNH THỨC
タイヤ		lốp xe	tyre
ティッシュペーパー		giấy ăn	tissue paper
半透明	はんとうめい	bán trong suốt	BÁN THẤU MINH
不気味	ぶきみ	đáng sợ, rùng rợn, kỳ quái, bất an	BẤT KHÍ VỊ
不細工	ぶさいく	vụng về, xấu; xấu xí	BẤT TẾ CÔNG
薄暗い	うすぐらい	hơi tối	BẠC ÁM
薄明るい	うすあかるい	mờ sáng	BẠC MINH
薄っぺら	うすっぺら	rất mỏng, mỏng manh; nông cạn, thiếu chiều sâu	BẠC
課す	かす	giao (bài tập, nhiệm vụ...); áp đặt	KHÓA
憎む	にくむ	ghét, căm ghét	TĂNG
贈る	おくる	tặng, biếu, trao quà	TẶNG
語る	かたる	kể về	NGỮ
演じる	えんじる	diễn, đóng (vai)	DIỄN
越える	こえる	vượt qua, đi qua, vượt lên trên	VIỆT
くたびれる		mệt mỏi, mệt rã rời; cũ nát, sờn	
組む	くむ	lên (lịch), lập (kế hoạch, nhóm, đội);	TỔ
組む	くむ	khoanh, khoác (tay), vắt (chân);	TỔ
縛る	しばる	trói buộc, cột	PHƯỢC
しゃがむ		ngồi xổm	
戦う	たたかう	chiến đấu, tranh đấu	CHIẾN
解く	ほどく	tháo ra, gỡ ra	GIẢI
解ける	ほどける	bị tháo ra, bị tuột; được xoa dịu, được cởi bỏ	GIẢI
怒鳴る	どなる	hét lên, quát	NỘ MINH
慰める	なぐさめる	an ủi, động viên	ÚY
生える	はえる	mọc	SINH
量る	はかる	đo lường (về trọng lượng, dung tích, thể tích, ...)	LƯỢNG
向かう	むかう	hướng về phía;	HƯỚNG
略す	りゃくす	lượt bớt, viết tắt, tóm gọn	LƯỢC
怠ける	なまける	lười biếng	ĐÃI
治療	ちりょう	điều trị, trị liệu	TRỊ LIỆU
専用	せんよう	dành riêng cho	CHUYÊN DỤNG
専属	せんぞく	độc quyền, làm riêng	CHUYÊN CHÚC
省略	しょうりゃく	lược bớt	TỈNH LƯỢC
悪化	あっか	sự xấu đi, sự tồi tệ hơn	ÁC HÓA
対立	たいりつ	đối lập	ĐỐI LẬP
開会	かいかい	khai mạc, mở đầu	KHAI HỘI
経由	けいゆ	đi qua, quá cảnh; thông qua	KINH DO
区分	くぶん	phân chia	KHU PHÂN
ダッシュ		chạy nhanh, chạy tốc độ cao	dash
チェックイン		thủ tục nhận phòng	check in
一層	いっそう	hơn hẳn, thêm nữa, ngày càng rõ rệt	NHẤT TẰNG
〜畳	〜じょう	đơn vị đo diện tích phòng, một tấm tatami	ĐIỆP
非〜	ひ〜	không, trái với, không thuộc về, chỉ sự phủ định hoặc ngược lại	PHI
不〜	ふ〜	không, sai, trái với quy chuẩn, chỉ sự phủ định hoặc thiếu sót trong điều kiện, trạng thái nào đó	BẤT
無〜	む〜	không, thiếu, không có, dùng để chỉ thiếu sót, thiếu thốn về vật chất hoặc tinh thần	VÔ
真〜		ま〜thực sự, chân thật, chính xác	CHÂN
未〜	み〜	chưa, chưa làm gì, chưa xảy ra	VỊ
来〜	らい〜	sắp tới, trong tương lai	LAI
童話	どうわ	truyện cổ tích	ĐỒNG THOẠI
福祉	ふくし	phúc lợi	PHÚC CHỈ
裕福	ゆうふく	giàu có, dư dả, sung túc	DỤ PHÚC
大幅	おおはば	lớn, (tăng, giảm) mạnh, một cách đáng kể	ĐẠI PHÚC
吐き気	はきけ	cảm giác buồn nôn	THỔ KHÍ
占い	うらない	sự bói toán	CHIÊM
点滴	てんてき	truyền dịch;sự nhỏ giọt	ĐIỂM TÍCH
砂漠	さばく	sa mạc	SA MẠC
マニュアル		sổ hướng dẫn	manual
事実	じじつ	sự thật; thật sự, thực tế	SỰ THỰC
利点	りてん	ưu điểm, điểm lợi	LỢI ĐIỂM
公共	こうきょう	công cộng	CÔNG CỘNG
公式	こうしき	chính thức	CÔNG THỨC
後者	こうしゃ	người sau; cái sau	HẬU GIẢ
口実	こうじつ	lấy cớ, viện lí do	KHẨU THỰC
高速	こうそく	cao tốc; tốc độ nhanh	CAO TỐC
高度	こうど	độ cao; mức cao, cao độ	CAO ĐỘ
小型	こがた	kích thước nhỏ, loại nhỏ	TIỂU HÌNH
顧客	こきゃく	khách hàng	CỐ KHÁCH
心当たり	こころあたり	có chút manh mối, chút kí ức về	TÂM ĐƯƠNG
小言	こごと	phàn nàn, than phiền, lời kêu ca; trách mắng, rầy la	TIỂU NGÔN
個体	こたい	cá thể	CÁ THỂ
言葉遣い	ことばづかい	cách sử dụng từ ngữ, cách ăn nói	NGÔN DIỆP KHIỂN
私語	しご	nói chuyện riêng	TƯ NGỮ
視線	しせん	hướng nhìn, ánh mắt; ánh nhìn	THỊ TUYẾN
死体	したい	thi thể, xác chết	TỬ THỂ
視聴者	しちょうしゃ	khán giả, người xem truyền hình	THỊ THÍNH GIẢ
しっぽ		đuôi - (động vật)	
視点	してん	quan điểm, góc nhìn	THỊ ĐIỂM
洗面所	せんめんじょ	chỗ rửa mặt, nhà vệ sinh	TẨY DIỆN SỞ
従業員	じゅうぎょういん	nhân viên	TÙNG NGHIỆP VIÊN
時給	じきゅう	lương theo giờ	THỜI CẤP
やりがい		đáng làm	
若々しい	わかわかしい	trẻ trung	NHƯỢC
健やか	すこやか	khỏe mạnh, khỏe khoắn	KIỆN
占う	うらなう	bói, xem bói; dự đoán	CHIÊM
占める	しめる	chiếm	CHIÊM
滴る	したたる	nhỏ giọt, rơi xuống	TRÍCH
彫る	ほる	khắc, tạc	KHẮC
書き込む	かきこむ	viết vào, nhập vào	THƯ NHẬP
仕上がる	しあがる	được kết thúc, được hoàn thành	SĨ THƯỢNG
立ち止まる	たちどまる	dừng lại	LẬP CHỈ
取り上げる	とりあげる	nhặt lên, lấy, chọn	THỦ THƯỢNG
取り出す	とりだす	lấy ra, rút ra	THỦ XUẤT
取り付ける	とりつける	lắp đặt, gắn vào	THỦ PHÓ
引っ張る	ひっぱる	kéo, lôi kéo	DẪN TRƯƠNG
微笑む	ほほえむ	mỉm cười	VI TIẾU
見下ろす	みおろす	nhìn xuống	KIẾN HẠ
横切る	よこぎる	băng qua	HOÀNH THIẾT
生かす	いかす	tận dụng, phát huy; cứu sống, để sống	SINH
独占	どくせん	sự độc chiếm, chiếm toàn bộ	ĐỘC CHIẾM
指摘	してき	chỉ ra, nêu lên	CHỈ TÍCH
実践	じっせん	thực hành	THỰC TIỄN
貢献	こうけん	cống hiến, đóng góp	CỐNG HIẾN
工作	こうさく	thủ công, chế tạo	CÔNG TÁC
交替	こうたい	thay phiên, luân phiên	GIAO THẾ
交代	こうたい	thay người, thay vị trí	GIAO ĐẠI
考慮	こうりょ	cân nhắc, xem xét, suy tính	KHẢO LỰ
視察	しさつ	thị sát	THỊ SÁT
息切れ	いきぎれ	thở dốc, khó thở; mất sức, hụt hơi	TỨC THIẾT
転職	てんしょく	chuyển việc	CHUYỂN CHỨC
定着	ていちゃく	sự ổn định; ăn sâu, bám rễ lâu dài	ĐỊNH TRỨC
あまりにも		quá, quá mức	
ごちゃごちゃ		lung tung, hỗn độn	
うっかり		lơ đễnh, không để ý	
うろうろ		lảng vảng, loanh qua loanh quanh	
がらがら		vắng tanh vắng ngắt; khản giọng	
ぎっしり		lèn chặt, đầy chặt, kín lịch	
こっそり		bí mật, lén lút	
ぐらぐら		lung lay, rung lắc, lắc lư; (nước sôi) sùng sục;	
副〜	ふく〜	phụ, đi kèm theo, mang tính bổ sung hoặc phụ trợ.	PHỤ
初〜	しょ〜	lần đầu, lần đầu tiên.	SƠ
〜切れ	〜ぎれ	hết, thiếu, hết sạch	THIẾT
〜頃	〜ごろ	khoảng, thời điểm thích hợp để làm gì đó	KHOẢNH
〜式	〜しき	lễ~	THỨC
〜式	〜しき	kiểu, hình thức, cách thức	THỨC
〜集	〜しゅう	bộ sưu tập, tập hợp, nhóm các thứ liên quan đến một chủ đề	TẬP
〜色	〜しょく	màu sắc, đặc điểm về màu sắc	SẮC
芝居	しばい	kịch; diễn, diễn xuất; diễn trò, giả vờ	CHI CƯ
住居	じゅうきょ	nơi ở, nơi cư trú	TRÚ CƯ
金属	きんぞく	kim loại	KIM THUỘC
堀	ほり	mương, hào	QUẬT
街角	まちかど	góc phố, góc đường	NHAI GIÁC
現状	げんじょう	hiện trạng, tình trạng hiện nay	HIỆN TRẠNG
根性	こんじょう	bản chất; bản lĩnh, tinh thần kiên cường	CĂN TÍNH
冷静	れいせい	bình tĩnh, tỉnh táo, điềm tĩnh	LÃNH TĨNH
根気	こんき	kiên nhẫn, kiên trì	CĂN KHÍ
献立	こんだて	thực đơn	HIẾN LẬP
今日	こんにち	hôm nay; ngày nay, hiện tại	KIM NHẬT
根本	こんぽん	cái gốc, cái căn bản, gốc rễ	CĂN BẢN
後日	ごじつ	sau, một ngày khác, ngày hôm khác	HẬU NHẬT
ご無沙汰	ごぶさた	lâu rồi không liên lạc, lâu rồi không gặp (cách nói khiêm nhường và lịch sự)	VÔ SA THÁI
細菌	さいきん	vi khuẩn	TẾ KHUẨN
細胞	さいぼう	tế bào	TẾ BÀO
差し支える	さしつかえる	trở ngại, cản trở	SAI CHI
山頂	さんちょう	đỉnh núi	SƠN ĐÍCH
温もり	ぬくもり	sự ấm áp, hơi ấm	ÔN
狙い	ねらい	mục tiêu, ý định	THƯ
のり		keo dán (糊); rong biển (海苔)	
歯車	はぐるま	bánh răng	XỈ XA
はしご		cái thang	
反感	はんかん	ác cảm, không ưa	PHẢN CẢM
半島	はんとう	bán đảo	BÁN ĐẢO
マスター		bậc thầy, giỏi, thành thạo	master
ムード		không khí, bầu không khí (chung của một nơi hoặc thời điểm)	mood
メーター		đồng hồ đo (tốc độ, nhiệt độ, điện,...)	meter
メリット		lợi ích, ưu điểm, điểm mạnh	merit
おす		con đực	
めす		con cái	
辛い	つらい	đau khổ, khó chịu	TÂN
属す	ぞくす	thuộc về, trực thuộc	THUỘC
追いかける	おいかける	đuổi theo	TRUY
腰かける	こしかける	ngồi xuống	YÊU
問いかける	といかける	hỏi, đặt câu hỏi	VẤN
取りかかる	とりかかる	bắt đầu, bắt tay	THỦ
話しかける	はなしかける	bắt chuyện	THOẠI
呼びかける	よびかける	gọi; kêu gọi	HÔ
乗り越す	のりこす	đi quá (ga mà đáng lẽ phải xuống)	THẶNG QUÁ
見逃す	みのがす	bỏ lỡ, bỏ sót; lờ đi, làm ngơ	KIẾN ĐÀO
癒す	いやす	chữa lành, xoa dịu, làm dịu	DŨ
気遣う	きづかう	lo lắng, bận tâm đến	KHÍ SOÁT
過ち	あやまち	sai lầm, lỗi lầm, tội lỗi	QUÁ
居眠り	いねむり	ngủ gật	CƯ MIÊN
同居	どうきょ	sống chung	ĐỒNG CƯ
所属	しょぞく	trực thuộc	SỞ THUỘC
避難	ひなん	sơ tán, lánh nạn	TỴ NẠN
開封	かいふう	mở phong bì, mở thư	KHAI PHONG
一致	いっち	thống nhất, nhất trí, trùng khớp	NHẤT TRÍ
超過	ちょうか	vượt quá	SIÊU QUÁ
抽選	ちゅうせん	rút thăm	TRỪU TUYỂN
進行	しんこう	tiến triển	TIẾN HÀNH
決断	けつだん	quyết định dứt khoát, quyết đoán	QUYẾT ĐOẠN
孤立	こりつ	cô lập	CÔ LẬP
婚約	こんやく	đính hôn	HÔN ƯỚC
娯楽	ごらく	giải trí, tiêu khiển	NGU LẠC
作動	さどう	hoạt động, chạy (máy móc, thiết bị)	TÁC ĐỘNG
廃止	はいし	bãi bỏ, hủy bỏ	PHẾ CHỈ
配分	はいぶん	phân phối, phân chia, phân bổ	PHỐI PHÂN
半減	はんげん	giảm một nửa	BÁN GIẢM
さらさら		xào xạc; róc rách; mềm mượt	
ざっと		lướt qua, sơ qua; khoảng chừng; (đổ) ào	
たった		chỉ (nhấn mạnh số lượng nhỏ)	
だぶだぶ		rộng thùng thình	
どっと		đồng loạt (cất tiếng...); bất chợt (ập đến)	
のろのろ		chậm rãi, lề mề	
はらはら		nóng ruột, lo lắng; (rơi) lả tả	
ばったり		tình cờ; đột ngột (ngã) gục, (đổ) sầm	
ばらばら		riêng lẻ, rời rạc, lung tung	
ぴかぴか		lấp lánh, sáng bóng, bóng loáng	
～会	〜かい	hội, buổi, sự kiện ~	HỘI
～街	～がい	khu phố, khu vực (tập trung loại hình, hoạt động nào đó)	NHAI
～順	〜じゅん	thứ tự, sắp xếp theo ~	THUẬN
～場	～じょう	địa điểm, nơi (diễn ra một hoạt động cụ thể)	TRƯỜNG
～済み	〜ずみ	đã xong, hoàn tất ~	TẾ
～性	〜せい	đặc tính, tính chất, khả năng	TÍNH
～制	〜せい	chế độ, hệ thống ~	CHẾ
施設	しせつ	cơ sở (được xây dựng cho một mục đích nhất định)	THI THIẾT
皮膚	ひふ	da, làn da	BÌ PHU
破片	はへん	mảnh vỡ	PHÁ PHIẾN
大被害	だいひがい	thiệt hại lớn, thiệt hại nghiêm trọng	ĐẠI BỊ HẠI
頭脳	ずのう	bộ não, trí óc, sự thông minh, trí tuệ	ĐẦU NÃO
プライバシー		cá nhân, riêng tư	privacy
アンテナ		ăng ten	antenna
グラフ		biểu đồ, đồ thị, đồ hình.	graph
非常識	ひじょうしき	vô ý thức, thiếu ý thức	PHI THƯỜNG THỨC
楽観的	らっかんてき	lạc quan	LẠC QUAN ĐÍCH
いたずら		nghịch ngợm	
水分	すいぶん	nước (trong cơ thể, vật thể,...)	THỦY PHÂN
あらすじ		nội dung tóm tắt (của truyện, sách, bài viết,...)	
経費	けいひ	kinh phí, chi phí	KINH PHÍ
事業	じぎょう	công việc kinh doanh, dự án	SỰ NGHIỆP
紙幣	しへい	tiền giấy	CHỈ TỆ
縞	しま	họa tiết sọc, vằn sọc	CẢO
霜	しも	sương giá	SƯƠNG
車両	しゃりょう	toa tàu; phương tiện tàu, xe ô tô nói chung	XA LƯỠNG
手話	しゅわ	thủ ngữ, ngôn ngữ ký hiệu	THỦ THOẠI
瞬間	しゅんかん	khoảnh khắc, phút chốc	THUẤN GIAN
商社	しょうしゃ	công ty thương mại	THƯƠNG XÃ
少数	しょうすう	số ít, thiểu số	THIỂU SỐ
勝敗	しょうはい	việc thắng thua	THẮNG BẠI
食卓	しょくたく	bàn ăn	THỰC TRÁC
所在	しょざい	vị trí, nơi ở	SỞ TẠI
書道	しょどう	thư pháp	THƯ ĐẠO
書物	しょもつ	sách vở	THƯ VẬT
神経	しんけい	thần kinh	THẦN KINH
芯	しん	lõi, ruột, phần lõi bên trong	TÂM
電流	でんりゅう	dòng điện	ĐIỆN LƯU
問い	とい	câu hỏi, thắc mắc	VẤN
塔	とう	tòa tháp	THÁP
当番	とうばん	phiên, ca trực	ĐƯƠNG PHIÊN
動機	どうき	động cơ, lý do	ĐỘNG KI
半ば	なかば	một nửa, ở giữa	BÁN
長年	ながねん	nhiều năm	TRƯỜNG NIÊN
眺め	ながめ	quang cảnh, cảnh vật nhìn thấy	THIẾU
無し	なし	không có	VÔ
謎	なぞ	điều bí ẩn	MÊ
縄	なわ	dây thừng	THẰNG
肉類	にくるい	các loại thịt	NHỤC LOẠI
日光	にっこう	ánh nắng	NHẬT QUANG
図々しい	ずうずうしい	trơ trẽn, vô liêm sỉ	ĐỒ
透明	とうめいな	trong suốt, trong trẻo	THẤU MINH
背負う	せおう	đeo, mang trên lưng; gánh vác, đảm đương	BỐI PHỤ
引き離す	ひきはなす	kéo ra, tách ra	DẪN LY
切ない	せつない	đau lòng	THIẾT
殺菌	さっきん	sát khuẩn, diệt khuẩn, tiệt trùng	SÁT KHUẨN
自殺	じさつ	tự sát, tự tử	TỰ SÁT
破産	はさん	phá sản	PHÁ SẢN
侵害	しんがい	xâm phạm, vi phạm	XÂM HẠI
支配	しはい	chi phối, kiểm soát	CHI PHỐI
育成	いくせい	sự nuôi dưỡng, bồi dưỡng, đào tạo	DỤC THÀNH
信仰	しんこう	lòng tin tôn giáo, tín ngưỡng, theo (đạo)	TÍN NGƯỠNG
集会	しゅうかい	cuộc họp, hội họp	TẬP HỘI
宿泊	しゅくはく	nghỉ lại, trọ lại	TÚC BẠC
出願	しゅつがん	đơn xin, nộp đơn	XUẤT NGUYỆN
出産	しゅっさん	sinh đẻ	XUẤT SẢN
消化	しょうか	tiêu hóa, xử lý	TIÊU HÓA
消毒	しょうどく	khử độc, khử trùng	TIÊU ĐỘC
勝負	しょうぶ	thắng thua; thi đấu, phân thắng bại	THẮNG PHỤ
消耗	しょうもう	tiêu tốn, tiêu hao	TIÊU HÁO
伝染	でんせん	truyền nhiễm, lây truyền	TRUYỀN NHIỄM
伝達	でんたつ	truyền đạt	TRUYỀN ĐẠT
得点	とくてん	điểm số, ghi điểm	ĐẮC ĐIỂM
共働き	ともばたらき	vợ chồng cùng đi làm	CỘNG ĐỘNG
長生き	ながいき	sống thọ, sống lâu	TRƯỜNG SINH
入荷	にゅうか	nhập hàng	NHẬP HÀ
入手	にゅうしゅ	có được, lấy được, nhận được	NHẬP THỦ
認識	にんしき	nhận thức, sự nhận biết	NHẬN THỨC
ふらふら		choáng váng, lảo đảo; không ổn định, không kiên định	
ぶらぶら		đong đưa, lủng lẳng; rảnh rỗi, không làm gì, thất nghiệp; lang thang, loanh quanh	
〜離れ	〜ばなれ	rời xa, không còn sử dụng/thích/quan tâm đến nữa	LI
お勧め	おすすめ	gợi ý, đề xuất, giới thiệu	KHUYẾN
焦点	しょうてん	tiêu điểm, trọng tâm	TIÊU ĐIỂM
高水準	こうすいじゅん	tiêu chuẩn cao, mức cao	CAO THỦY CHUẨN
準決勝	じゅんけっしょう	vòng/ trận bán kết	CHUẨN QUYẾT THẮNG
催し	もよおし	sự kiện, buổi lễ	THÔI
看護	かんご	điều dưỡng	KHÁN HỘ
看護師	かんごし	điều dưỡng viên	KHÁN HỘ SĨ
弁護士	べんごし	luật sư	BIỆN HỘ SĨ
工芸	こうげい	thủ công mỹ nghệ	CÔNG NGHỆ
芸能界	げいのうかい	giới nghệ thuật, giới giải trí	NGHỆ NĂNG GIỚI
並木	なみき	hàng cây	TỊNH MỘC
急速	きゅうそく	nhanh chóng, cấp tốc	CẤP TỐC
足元	あしもと	dưới chân, bước chân	TÚC NGUYÊN
定時	ていじ	giờ cố định, thời gian quy định	ĐỊNH THỜI
回数	かいすう	số lần	HỒI SỔ
セミナー		hội thảo	seminar
プリンター		máy in	printer
憲法	けんぽう	hiến pháp	HIẾN PHÁP
原子力	げんしりょく	năng lượng hạt nhân, năng lượng nguyên tử	NGUYÊN TỬ LỰC
原理	げんり	nguyên lý, lý thuyết cơ bản	NGUYÊN LÝ
心身	しんしん	tinh thần và thể xác, cơ thể và tâm hồn	TÂM THÂN
神話	しんわ	thần thoại	THẦN THOẠI
引き分け	ひきわけ	hòa, bất phân thắng bại	DẪN PHÂN
ひざ		đầu gối	
ひじ		khuỷu tay	
必需品	ひつじゅひん	vật dụng thiết yếu, đồ dùng cần thiết	TẤT NHU PHẨM
人通り	ひとどおり	người qua lại	NHÂN THÔNG
瞳	ひとみ	đồng tử, đôi mắt	ĐỒNG
独り	ひとり	một người, một mình, đơn độc	ĐỘC
日の入り	ひのいり	hoàng hôn	NHẬT NHẬP
日の出	ひので	bình minh	NHẬT XUẤT
風船	ふうせん	bóng bay	PHONG THUYỀN
付近	ふきん	khu vực gần, vùng xung quanh	PHỤ CẬN
基礎	きそ	cơ bản, nền tảng	CƠ SỞ
フェア		công bằng	fair
フレッシュ		tươi, tươi mới	fresh
フロア		tầng, sàn	floor
ブロッコリー		súp lơ xanh	broccoli
プライド		lòng tự trọng, niềm kiêu hãnh	pride
ニーズ		nhu cầu, yêu cầu	needs
余計	よけい	thừa, dư thừa, không cần thiết	DƯ KÊ
荒い	あらい	dữ dội; thô lỗ, cộc cằn	HOANG
焦る	あせる	vội vã, nóng vội	TIÊU
雇う	やとう	thuê (người)	CỐ
立ち並ぶ	たちならぶ	đứng thành hàng, đứng san sát	LẬP TỊNH
驚く	おどろく	ngạc nhiên, bất ngờ	KINH
驚かす	おどろかす	làm giật mình, làm ngạc nhiên	KINH
訴える	うったえる	kiện, tố cáo, kêu ca, phản ánh	TỐ
促す	うながす	thúc giục, khuyến khích	XÚC
うなずく		gật đầu	
治める	おさめる	cai trị, quản lý	TRỊ
代える	かえる	thay thế	ĐẠI
輝く	かがやく	tỏa sáng lấp lánh, rạng rỡ	HUY
嗅ぐ	かぐ	ngửi	KHỨU
傾ける	かたむける	làm nghiêng; dồn tình cảm, dốc sức	KHUYNH
及ぼす	およぼす	làm ảnh hưởng, gây ra	CẬP
生み出す	うみだす	tạo ra, sản sinh, mang lại	SINH XUẤT
勧誘	かんゆう	mời gọi, lôi kéo, khuyến khích	KHUYẾN DỤ
警告	けいこく	cảnh báo	CẢNH CÁO
購入	こうにゅう	mua	CẤU NHẬP
再会	さいかい	gặp lại, tái ngộ	TÁI HỘI
一段落	いちだんらく	tạm ổn, tạm xong	NHẤT ĐOẠN LẠC
確定	かくてい	xác định	XÁC ĐỊNH
選出	せんしゅつ	bầu chọn, tuyển chọn	TUYỂN XUẤT
チェックアウト		làm thủ tục trả phòng	check-out
下車	げしゃ	xuống xe	HẠ XA
厳守	げんしゅ	tuân thủ nghiêm ngặt	NGHIÊM THỦ
申告	しんこく	khai báo	THÂN CÁO
審判	しんぱん	thẩm phán, trọng tài	THẨM PHÁN
反発	はんぱつ	phản đối, phản kháng	PHẢN PHÁT
一休み	ひとやすみ	nghỉ ngơi một lát, nghỉ chân	NHẤT HƯU
非難	ひなん	trách móc, chỉ trích, đổ lỗi	PHI NAN
かっとする		nổi giận, phát bực	
予感	よかん	dự cảm, linh cảm	DỰ CẢM
ぐずぐず		lề mệ, chần chừ, do dự, trì hoãn	
牧場	ぼくじょう	trang trại	MỤC TRÀNG
開放感	かいほうかん	cảm giác tự do, cảm giác được giải phóng	KHAI PHÓNG CẢM
～放題	〜ほうだい	thoải mái làm ~, làm ~ bao nhiêu tùy thích	PHÓNG ĐỀ
衛生	えいせい	vệ sinh	VỆ SINH
衛星	えいせい	vệ tinh	VỆ TINH
人工衛星	じんこうえいせい	vệ tinh nhân tạo	NHÂN CÔNG VỆ TINH
唯一	ゆいいつ	duy nhất	DUY NHẤT
宴会	えんかい	buổi tiệc	YẾN HỘI
夏バテ	なつばて	cảm giác mệt mỏi, uể oải vào mùa hè do nhiệt độ cao	HẠ
旦那	だんな	chồng mình	ĐÁN NA
仮病	けびょう	giả bệnh, giả vờ ốm	GIẢ BỆNH
しゃっくり		nấc cụt	
職場	しょくば	chỗ làm	CHỨC TRƯỜNG
ロケット		tên lửa	
高収入	こうしゅうにゅう	thu nhập cao	CAO THU NHẬP
紫	むらさき	màu tím	TỬ
姪	めい	cháu gái (con của anh/chị)	ĐIỆT
名物	めいぶつ	đặc sản	DANH VẬT
免疫	めんえき	sự miễn dịch	MIỄN DỊCH
面積	めんせき	diện tích	DIỆN TÍCH
目次	もくじ	mục lục	MỤC THỨ
模型	もけい	mô hình, hình mẫu	MÔ HÌNH
物真似	ものまね	sự bắt chước	VẬT CHÂN TỰ
役人	やくにん	công chức, cán bộ nhà nước	DỊCH NHÂN
野生	やせい	hoang dã	DÃ SINH
用語	ようご	thuật ngữ	DỤNG NGỮ
要旨	ようし	ý chính, nội dung chính	YẾU CHỈ
要所	ようしょ	địa điểm/ vị trí trọng yếu; phần/ chỗ quan trọng	YÊU SỞ
用品	ようひん	đồ dùng, dụng cụ	DỤNG PHẨM
容量	ようりょう	dung lượng, dung tích	DUNG LƯỢNG
翌朝	よくあさ	sáng hôm sau	DỰC TRIỀU
横道	よこみち	đường phụ; lạc đề	HOÀNH ĐẠO
よそ者	よそもの	người ngoài, người lạ	GIẢ
デスクトップ		máy tính để bàn	desktop
デメリット		nhược điểm, bất lợi	demerit
電気ポット	でんきポット	ấm điện	ĐIỆN KHÍ
ハト		chim bồ câu	
バザー		chợ/ khu bán hàng cũ	
ヒーター		máy sưởi	
ビジョン		tầm nhìn	
徹底的	てっていてき	triệt để, kỹ lưỡng	TRIỆT ĐỂ ĐÍCH
象徴的	しょうちょうてき	mang tính biểu tượng, tượng trưng	TƯỢNG TRƯNG ĐÍCH
謙虚	けんきょ	khiêm tốn	KHIÊM HƯ
憂鬱	ゆううつ	buồn rầu, ủ rũ, ảm đạm, chán nản	ƯU UẤT
キンキン		(lạnh) buốt, thấu xương; (tiếng) the thé, rè	
放す	はなす	thả ra; buông tay	PHÓNG
兼ねる	かねる	kiêm cả hai	KIÊM
築く	きずく	xây dựng	TRÚC
迫る	せまる	đến sát, tiến gần; dồn, ép	BÁCH
逸れる	それる	chệch hướng, lạc lối	DẬT
放棄	ほうき	từ bỏ	PHÓNG KHÍ
放出	ほうしゅつ	thải ra, phát ra; cho đi	PHÓNG XUẤT
往復	おうふく	khứ hồi, đi rồi quay về	VÃNG PHỤC
往来	おうらい	(người, phương tiện đi) qua lại	VÃNG LAI
服従	ふくじゅう	sự phục tùng, tuân theo	PHỤC TÙNG
明示	めいじ	nêu rõ, chỉ rõ	MINH THỊ
遺言	ゆいごん	trăn trối, di chúc	DI NGÔN
輸血	ゆけつ	truyền máu	THÂU HUYẾT
輸送	ゆそう	vận chuyển	THÂU TỐNG
用心	ようじん	cẩn thận, quan tâm, để ý	DỤNG TÂM
予告	よこく	thông báo trước	DỰ CÁO
予選	よせん	vòng loại, vòng sơ khảo, sơ tuyển	DỰ TUYỂN
粒	つぶ	hạt	LẠP
灯台	とうだい	ngọn hải đăng	ĐĂNG ĐÀI
防災	ぼうさい	phòng chống thiên tai	PHÒNG TAI
炭	すみ	than	THAN
岸	きし	bờ, bãi (biển, sông)	NGẠN
先端	せんたん	đầu, mũi (vật); đi đầu, tiên tiến	TIÊN ĐOAN
粉	こな	bột	PHẤN
精いっぱい	せいいっぱい	cố gắng hết sức, làm hết sức mình.	TINH
嵐	あらし	cơn bão, giông bão	LAM
クラシック		cổ điển, nhạc cổ điển	
身振り	みぶり	cử chỉ, điệu bộ cơ thể	THÂN CHẤN
手振り	てぶり	cử chỉ tay	THỦ CHẤN
間取り	まどり	sự bố trí các phòng, sơ đồ nhà	GIAN THỦ
合間	あいま	thời gian rảnh, chỗ trống (giữa 2 hay nhiều sự vật sự việc)	HỢP GIAN
圧力	あつりょく	áp lực, sức ép	ÁP LỰC
過失	かしつ	sơ suất, bất cẩn, lỗi	QUÁ THẤT
箇所	かしょ	nơi, chỗ	CÁ SỞ
文明	ぶんめい	văn minh	VĂN MINH
味付け	あじつけ	nêm gia vị	VỊ PHÓ
角度	かくど	góc; góc độ, phương diện	GIÁC ĐỘ
陰	かげ	bóng râm; sau lưng	ÂM
果実	かじつ	quả, trái cây	QUẢ THỰC
部門	ぶもん	bộ phận	BỘ MÔN
分割払い	ぶんかつばらい	trả góp	PHÂN CÁT PHẤT
頬	ほほ	má	GIÁP
北極	ほっきょく	bắc cực	BẮC CỰC
炎	ほのお	ngọn lửa	VIÊM
本質	ほんしつ	bản chất, cái cốt lõi	BẢN CHẤT
冒険	ぼうけん	chuyến phiêu lưu, mạo hiểm	MẠO HIỂM
まぶた		mí mắt	
魔法	まほう	phép thuật, ma thuật	MA PHÁP
実	み	quả	THỰC
三日月	みかづき	trăng lưỡi liềm	TAM NHẬT NGUYỆT
味噌	みそ	miso (gia vị nhật bản)	VỊ TÀO
道のり	みちのり	quãng đường, chặng đường	ĐẠO
密度	みつど	mật độ	MẬT ĐỘ
見積書	みつもりしょ	bảng báo giá	KIẾN TÍCH THƯ
身の回り	みのまわり	những thứ xung quanh bản thân (đồ dùng cá nhân, việc sinh hoạt thường ngày,...)	THÂN HỒI
身分	みぶん	thân phận	THÂN PHÂN
未満	みまん	ít hơn, chưa đủ	VỊ MÃN
身元	みもと	lai lịch, danh tính	THÂN NGUYÊN
名字	みょうじ	họ	DANH TỰ
リズム		nhịp điệu, âm tiết	rhythm
生意気	なまいき	xấc láo, hỗn xược	SANH Ý KHÍ
暴く	あばく	vạch trần, phơi bày	BẠO
暴れる	あばれる	quậy phá, làm loạn	BẠO
情けない	なさけない	đáng thất vọng, đáng xấu hổ; đáng thương, thảm hại	TÌNH
威張る	いばる	kiêu căng, ra vẻ, hách dịch	UY TRƯƠNG
かばう		che chắn, bảo vệ	
からかう		trêu chọc, chọc ghẹo	
代わる	かわる	thay thế	ĐẠI
鍛える	きたえる	rèn luyện, mài giũa	ĐOÁN
狂う	くるう	điên cuồng, phát điên	CUỒNG
苦しめる	くるしめる	làm đau khổ, dày vò	KHỔ
擦る	する	chà xát, cọ	SÁT
こだわる		để tâm, câu nệ	
探る	さぐる	điều tra, tìm kiếm	THAM
ささやく		thì thầm	
挿す	さす	cắm, cài	SÁP
授かる	さずかる	được ban, được truyền cho	THỤ
じたばたする		vùng vẫy, giãy giụa	
さびる		bị rỉ sét	
敷く	しく	trải ra	PHU
静める	しずめる	làm nhỏ, làm yên lặng; làm dịu, trấn an, dập tắt	TĨNH
すすぐ		rửa sạch; súc (miệng)	
ずらす		dịch chuyển, làm lệch	
ずれる		trượt, lệch, đi chệch	
暴行	ぼうこう	bạo hành, hành hung, bạo lực	BẠO HÀNH
向上	こうじょう	sự tiến bộ, nâng cao	HƯỚNG THƯỢNG
前進	ぜんしん	tiến về phía trước, tiến bộ	TIỀN TIẾN
解釈	かいしゃく	diễn giải, hiểu, lý giải	GIẢI THÍCH
獲得	かくとく	giành được	HOẠCH ĐẮC
加工	かこう	gia công, chế biến; xử lí	GIA CÔNG
加速	かそく	tăng tốc	GIA TỐC
分配	ぶんぱい	phân chia, phân phối	PHÂN PHỐI
分量	ぶんりょう	lượng, khối lượng	PHÂN LƯỢNG
返答	へんとう	câu trả lời, trả lời, phản hồi	PHẢN ĐÁP
万引き	まんびき	ăn cắp vặt, kẻ trộm	VẠN DẪN
密着	みっちゃく	gắn chặt, bám sát	MẬT TRỨ
精々	せいぜい	tối đa, nhiều nhất có thể	TINH
証拠	しょうこ	bằng chứng, chứng cứ	CHỨNG CỨ
保証金	ほしょうきん	tiền đặt cọc, tiền bảo đảm	BẢO CHỨNG KIM
身分証明書	みぶんしょうめいしょ	giấy tờ tùy thân	THÂN PHÂN CHỨNG MINH THƯ
炎症	えんしょう	viêm	VIÊM CHỨNG
後遺症	こういしょう	di chứng	HẬU DI CHỨNG
症状	しょうじょう	triệu chứng	CHỨNG TRẠNG
武士	ぶし	võ sĩ	VÕ SĨ
地域	ちいき	khu vực, vùng	ĐỊA VỰC
裁判	さいばん	phiên toà, phiên xét xử	TÀI PHÁN
裁判所	さいばんしょ	tòa án	TÀI PHÁN SỞ
儀式	ぎしき	nghi thức, nghi lễ	NGHI THỨC
詳細	しょうさい	chi tiết	TƯỜNG TẾ
群れ	むれ	đàn, bầy (thú, chim...)	QUẦN
事柄	ことがら	sự việc, vấn đề	SỰ BÍNH
液体	えきたい	chất lỏng	DỊCH THỂ
絵の具	えのぐ	màu vẽ, thuốc màu	HỘI CỤ
活力	かつりょく	sinh lực, sức sống	HOẠT LỰC
鐘	かね	chuông	CHUNG
歌謡曲	かようきょく	ca khúc đại chúng, bài hát phổ biến	CA DAO KHÚC
為替	かわせ	tỷ giá hối đoái	VI THẾ
太鼓	たいこ	trống lớn	THÁI CỔ
体制	たいせい	thể chế, hệ thống	THỂ CHẾ
谷	たに	thung lũng	CỐC
束	たば	bó, bọc, búi	THÚC
ため息	ためいき	tiếng thở dài	TỨC
リゾート		khu nghỉ dưỡng	
善良	ぜんりょう	lương thiện, hiền lành	THIỆN LƯƠNG
神経質	しんけいしつ	nhạy cảm	THẦN KINH CHẤT
粗末	そまつ	sơ sài, thô kệch; cẩu thả, coi nhẹ	THÔ MẠT
対等	たいとう	bình đẳng	ĐỐI ĐẲNG
多様	たよう	đa dạng	ĐA DẠNG
妥当	だとう	hợp lý, thích đáng	THỎA ĐƯƠNG
同一	どういつ	giống nhau, đồng nhất	ĐỒNG NHẤT
膨大	ぼうだい	khổng lồ, to lớn	BÀNH ĐẠI
有利	ゆうり	có lợi, thuận lợi	HỮU LỢI
容易	ようい	dễ dàng	DUNG DỊ
陽気	ようき	vui vẻ, hồ hởi; thời tiết đẹp	DƯƠNG KHÍ
渋い	しぶい	chát; (màu/ giọng) trầm; khó chịu, bất mãn	SÁP
我慢強い	がまんづよい	chịu đựng giỏi, kiên nhẫn	NGÃ MẠN CƯỜNG
盛ん	さかん	thịnh vượng, phát triển	THỊNH
鮮やか	あざやか	rực rỡ, nổi bật; điêu luyện	TIÊN
常識的	じょうしきてき	lẽ thường	THƯỜNG THỨC ĐÍCH
平ら	たいら	bằng phẳng	BÌNH
着実	ちゃくじつ	vững chắc, chắc chắn, ổn định	TRƯỚC THỰC
滑らか	なめらか	mịn màng; trơn tru, trôi chảy	HOẠT
賑やか	にぎやか	náo nhiệt, nhộn nhịp	CHẨN
莫大	ばくだい	rất lớn, khổng lồ	MẠC ĐẠI
朗らか	ほがらか	tươi sáng, vui vẻ, cởi mở	LÃNG
惨め	みじめ	thảm hại, đáng thương	THẢM
緩やか	ゆるやか	(buộc) lỏng; êm dịu, chậm dãi; thoai thoải	HOÃN
楽天的	らくてんてき	lạc quan	LẠC THIÊN ĐÍCH
わずか		rất ít, chỉ một chút	CẬN
見事	みごと	tuyệt vời, xuất sắc	KIẾN SỰ
整える	ととのえる	chuẩn bị; sắp xếp, điều chỉnh, chỉnh trang	CHỈNH
扇ぐ	あおぐ	quạt	PHIẾN
呆れる	あきれる	ngao ngán, cạn lời	NGỐC
歩む	あゆむ	bước đi, đi; sống, trải bước (cuộc đời)	BỘ
うつむく		cúi gằm mặt, nhìn xuống	
整備	せいび	sửa chữa, bảo dưỡng	CHỈNH BỊ
繁盛	はんじょう	phát đạt, hưng thịnh	PHỒN THỊNH
昇進	しょうしん	thăng chức	THĂNG TIẾN
運営	うんえい	vận hành, điều hành	VẬN DOANH
加熱	かねつ	làm nóng, nấu	GIA NHIỆT
続行	ぞっこう	tiếp tục	TỤC HÀNH
応接	おうせつ	tiếp khách, tiếp đãi	ỨNG TIẾP
対決	たいけつ	đối đầu, đối kháng	ĐỐI QUYẾT
退出	たいしゅつ	rút lui, lui ra	THOÁI XUẤT
退場	たいじょう	rời sân, rút khỏi	THOÁI TRƯỜNG
対戦	たいせん	thi đấu, đối đầu (trong trận đấu)	ĐỐI CHIẾN
体操	たいそう	thể dục, bài thể dục	THỂ THAO
反応	はんのう	phản ứng	PHẢN ỨNG
増加	ぞうか	gia tăng	TĂNG GIA
掲載	けいさい	đăng tải (bài viết, hình ảnh...)	YẾT TÁI
活用	かつよう	vận dụng, sử dụng; sự biến đổi (động từ, tính từ,...)	HOẠT DỤNG
万歳	ばんざい	hô vạn tuế	VẠN TUẾ
只	ただ	chỉ là	CHÍCH
仮に	かりに	giả sử, tạm thời	GIẢ
～盛り	ざかり	diễn tả giai đoạn "cực thịnh", "đang ở đỉnh điểm", "thời kỳ sung mãn nhất" của một hiện tượng hoặc quá trình	THỊNH
～証	しょう	dùng để chỉ “giấy chứng nhận”, “chứng chỉ” liên quan đến một quyền lợi, thân phận, hoặc trạng thái nào đó	CHỨNG
金融	きんゆう	tài chính, tài vụ	KIM DUNG
通帳	つうちょう	sổ ngân hàng	THÔNG TRƯỚNG
帯	おび	dây đai, thắt lưng	ĐỚI
地帯	ちたい	khu vực, vùng	ĐỊA ĐỚI
熱帯	ねったい	nhiệt đới	NHIỆT ĐỚI
包帯	ほうたい	băng, gạc	BAO ĐỚI
衣装	いしょう	trang phục biểu diễn, lễ phục	Y TRANG
衣料品	いりょうひん	hàng may mặc, quần áo	Y LIÊU PHẨM
紙袋	かみぶくろ	túi giấy	CHỈ ĐẠI
木製	もくせい	làm bằng gỗ	MỘC CHẾ
猛暑	もうしょ	nắng nóng gay gắt	MÃNH THỬ
愚痴	ぐち	lời than phiền, than vãn	NGU SI
期日	きじつ	ngày hẹn, hạn chót	KÌ NHẬT
家屋	かおく	ngôi nhà	GIA ỐC
顔つき	かおつき	vẻ mặt	NHAN
読み手	よみて	người đọc	ĐỘC THỦ
嫁	よめ	con dâu; vợ	GIÁ
来場者	らいじょうしゃ	khách đến tham dự	LAI TRƯỜNG GIẢ
落語	らくご	truyện cười truyền thống Nhật	LẠC NGỮ
列島	れっとう	quần đảo	LIỆT ĐẢO
れんが		gạch (xây dựng)	
ろうそく		nến	
路線	ろせん	tuyến đường	LỘ TUYẾN
わが社	わがしゃ	công ty chúng tôi	XÃ
脇道	わきみち	đường nhánh, đường phụ	HIẾP ĐẠO
割り勘	わりかん	chia tiền	CÁT KHÁM
以来	いらい	kể từ khi	DĨ LAI
力づく	ちからづく	dùng sức, vũ lực	LỰC
各々	おのおの	mỗi người, từng người	CÁC
重苦しい	おもくるしい	nặng nề, ngột ngạt	TRỌNG KHỔ
気恥ずかしい	きはずかしい	ngại ngùng, xấu hổ	KHÍ SỈ
物凄い	ものすごい	kinh khủng, dữ dội	VẬT THÊ
弱々しい	よわよわしい	yếu ớt, mảnh mai	NHƯỢC
危うい	あやうい	nguy hiểm; lo ngại, bất an	NGUY
煙たい	けむたい	ngột ngạt vì khói	YÊN
そそっかしい		cẩu thả, không cẩn thận	
ばかばかしい		tào lao, nhảm nhí, vớ vẩn	
力強い	ちからづよい	mạnh mẽ, đầy sức mạnh	LỰC CƯỜNG
注意深い	ちゅういぶかい	cẩn trọng, thận trọng	CHÚ Ý THÂM
みっともない		đáng xấu hổ, mất thể diện	
むなしい		vô ích, trống rỗng	
厚かましい	あつかましい	mặt dày, trơ trẽn	HẬU
粗い	あらい	mờ; thô, chưa mịn	THÔ
淡い	あわい	nhạt, nhẹ	ĐẠM
規則正しい	きそくただしい	điều độ, đúng giờ giấc (sinh hoạt)	QUY TẮC CHÍNH
一時的	いちじてき	mang tính tạm thời	NHẤT THỜI ĐÍCH
一方的	いっぽうてき	phiến diện, đơn phương	NHẤT PHƯƠNG ĐÍCH
架空	かくう	hư cấu, tưởng tượng	GIÁ KHÔNG
良好	りょうこう	tốt, tốt đẹp	LƯƠNG HẢO
力づける	ちからづける	cổ vũ, khích lệ, tiếp sức	LỰC
補助	ほじょ	hỗ trợ, trợ cấp	BỔ TRỢ
補正	ほせい	chỉnh sửa, điều chỉnh	BỔ CHÍNH
包装	ほうそう	đóng gói, bao bì	BAO TRANG
装置	そうち	thiết bị, máy móc; lắp đặt	TRANG TRÍ
製作	せいさく	chế tác, sản xuất	CHẾ TÁC
回転	かいてん	xoay vòng, quay	HỒI CHUYỂN
回答	かいとう	trả lời, hồi đáp	HỒI ĐÁP
開幕	かいまく	khai mạc	KHAI MẠC
解約	かいやく	hủy hợp đồng	GIẢI ƯỚC
落第	らくだい	thi trượt, trượt môn	LẠC ĐỆ
連合	れんごう	liên minh, liên hiệp	LIÊN HỢP
連想	れんそう	liên tưởng	LIÊN TƯỞNG
露出	ろしゅつ	lộ ra, phơi bày	LỘ XUẤT
夜通し	よどおし	suốt đêm, thâu đêm	DẠ THÔNG
意外に	いがいに	ngoài dự đoán, bất ngờ	Ý NGOẠI
いずれも		cái nào cũng, bên nào cũng	
いまいち		chưa được lắm, thiếu thiếu gì đó	
いまどき		thời nay, ngày nay	
うかうかと		lơ đễnh, bất cẩn	
うじゃうじゃ		lúc nhúc, chen chúc	
思い切って	おもいきって	quyết tâm, dứt khoát làm gì đó	TƯ THIẾT
いわば		có thể nói là..., ví như là	
先祖	せんぞ	tổ tiên	TIÊN TỔ
祝日	しゅくじつ	ngày lễ	CHÚC NHẬT
即座	そくざ	ngay lập tức	TỨC TỌA
筆者	ひっしゃ	tác giả	BÚT GIẢ
管理下	かんりか	dưới sự quản lý	QUẢN LÝ HẠ
書籍	しょせき	sách vở	THƯ TỊCH
国籍	こくせき	quốc tịch	QUỐC TỊCH
模範	もはん	hình mẫu, tấm gương; khuôn mẫu	MÔ PHẠM
年寄り	としより	người già	NIÊN KÍ
大昔	おおむかし	ngày xưa, xa xưa	ĐẠI TÍCH
悪寒	おかん	ớn lạnh	ÁC HÀN
お気に入り	おきにいり	yêu thích	KHÍ NHẬP
お世辞	おせじ	sự nịnh nọt, tâng bốc	THẾ TỪ
落ち葉	おちば	lá rụng	LẠC DIỆP
鬼	おに	con quỷ	QUỶ
お負け	おまけ	đồ khuyến mãi, tặng kèm	PHỤ
観点	かんてん	góc nhìn, quan điểm	QUAN ĐIỂM
図表	ずひょう	biểu đồ	ĐỒ BIỂU
生物	せいぶつ	sinh vật	SINH VẬT
成分	せいぶん	thành phần	THÀNH PHÂN
赤道	せきどう	xích đạo	XÍCH ĐẠO
泉	いずみ	con suối	TUYỀN
一括払い	いっかつばらい	thanh toán một lần	NHẤT QUÁT PHẤT
お代わり	おかわり	thêm phần nữa	ĐẠI
生命	せいめい	sinh mệnh, sự sống	SINH MỆNH
正門	せいもん	cổng chính	CHÁNH MÔN
押し寄せる	おしよせる	ào ạt kéo đến, dồn dập	ÁP KÝ
立ち寄る	たちよる	tạt vào, ghé qua	LẬP KÝ
持ち寄る	もちよる	mỗi người mang một ít	TRÌ KÝ
束ねる	たばねる	bó lại, buộc lại; gắn kết	THÚC
留まる	とどまる	dừng lại, ở lại	LƯU
摂る	とる	hấp thụ	NHIẾP
撫でる	なでる	xoa, vuốt nhẹ	PHỦ
成る	なる	trở thành, tạo thành	THÀNH
ねじる		vặn, xoắn	
逃れる	のがれる	thoát khỏi, trốn tránh	ĐÀO
飛び降りる	とびおりる	nhảy xuống	PHI GIÁNG
飛び越える	とびこえる	nhảy qua	PHI VIỆT
飛び立つ	とびたつ	bay lên	PHI LẬP
取り組む	とりくむ	nỗ lực giải quyết, chuyên tâm	THỦ TỔ
取り払う	とりはらう	gỡ bỏ, loại bỏ	THỦ PHẤT
取り戻す	とりもどす	lấy lại, khôi phục	THỦ LỆ
鳴り出す	なりだす	bắt đầu vang lên	MINH XUẤT
冷え込む	ひえこむ	trở lạnh sâu	LÃNH NHẬP
引き分ける	ひきわける	hòa	DẪN PHÂN
引っ張り出す	ひっぱりだす	lôi ra, kéo ra	DẪN TRƯƠNG XUẤT
見張る	みはる	trông chừng, canh gác	KIẾN TRƯƠNG
見分ける	みわける	phân biệt	KIẾN PHÂN
やっ付ける	やっつける	đánh bại, làm cho xong	
やってくる		đến, xảy đến	
追い返す	おいかえす	đuổi về	TRUY PHẢN
追い付く	おいつく	đuổi kịp	TRUY PHÓ
思い返す	おもいかえす	nhớ lại, suy nghĩ lại	TƯ PHẢN
思い切る	おもいきる	quyết tâm	TƯ THIẾT
尽きる	つきる	cạn sức, cạn kiệt	TẪN
捉える	とらえる	nắm bắt, bắt được	TRÓC
勘違い	かんちがい	hiểu nhầm	KHÁM VI
請求	せいきゅう	yêu cầu, hóa đơn	THỈNH CẦU
成立	せいりつ	thành lập, hình thành	THÀNH LẬP
接近	せっきん	tiếp cận, đến gần	TIẾP CẬN
移住	いじゅう	di cư	DI TRÚ
返却	へんきゃく	trả lại	PHẢN KHƯỚC
筆記	ひっき	ghi chép, viết	BÚT KÝ
在籍	ざいせき	đang theo học/ làm việc tại...	TẠI TỊCH
生存	せいぞん	sinh tồn	SINH TỒN
あくまで		cho đến cùng, hoàn toàn, đến mức tối đa	
あちこち		khắp nơi	
うっすら		mờ nhạt, lờ mờ	
うっとり		mê mẩn, say đắm	
うんと		rất nhiều	
円満に	えんまんに	hòa thuận, êm đẹp	VIÊN MÃN
おおよそ		đại khái, ước chừng, xấp xỉ	
おそらく		có lẽ, e rằng	
〜状	〜じょう	dùng để chỉ các loại văn bản, thư từ trang trọng	〜TRẠNG
〜状	〜じょう	dạng ~, ở trạng thái ~	〜TRẠNG
古典	こてん	tác phẩm cổ điển	CỔ ĐIỂN
農作物	のうさくぶつ	hoa màu, cây trồng	NÔNG TÁC VẬT
農薬	のうやく	thuốc trừ sâu, hóa chất nông nghiệp	NÔNG DƯỢC
濃度	のうど	nồng độ	NÙNG ĐỘ
大臣	だいじん	bộ trưởng	ĐẠI THẦN
心臓	しんぞう	trái tim	TÂM TẠNG
器	うつわ	đồ đựng (chén, bát, hộp...);	KHÍ
海沿い	うみぞい	ven biển	HẢI DUYÊN
先進国	せんしんこく	nước phát triển	TIÊN TIẾN QUỐC
先頭	せんとう	vị trí dẫn đầu, đầu hàng	TIÊN ĐẦU
葬式	そうしき	lễ tang, đám tang	TÁNG THỨC
財産	ざいさん	tài sản	TÀI SẢN
アナウンサー		phát thanh viên, mc	
側面	そくめん	mặt bên; khía cạnh	TRẮC DIỆN
速力	そくりょく	tốc độ	TỐC LỰC
日頃	ひごろ	thường ngày, hàng ngày	NHẬT KHOẢNH
愛情	あいじょう	tình yêu, tình cảm	ÁI TÌNH
順位	じゅんい	thứ hạng, vị trí xếp hạng	THỨ VỊ
賢い	かしこい	thông minh, khôn ngoan	HIỀN
寝付きが悪い	ねつきがわるい	khó ngủ	TẨM PHÓ ÁC
典型的	てんけいてき	mang tính điển hình, tiêu biểu	ĐIỂN HÌNH ĐÍCH
濃厚	のうこう	đậm, dày; khả năng cao	NÙNG HẬU
賢明	けんめい	sáng suốt, khôn ngoan	HIỀN MINH
贅沢	ぜいたく	sang trọng, xa xỉ	CHUẾ TRẠCH
振舞う	ふるまう	thiết đãi, chiêu đãi;	CHẤN VŨ
振り返る	ふりかえる	ngoảnh lại, quay đầu lại; nhìn lại	CHẤN PHẢN
掃く	はく	quét	TẢO
侵す	おかす	xâm phạm; xâm chiếm	XÂM
溺れる	おぼれる	chết đuối;	NỊCH
計る	はかる	đo	KẾ
嵌める	はめる	đeo vào, lắp vào	KHẢM
惹く	ひく	thu hút, hấp dẫn	NHẠ
捻る	ひねる	vặn, xoay (vật thể);	NIỆP
塞がる	ふさがる	bị bịt kín, tắc nghẽn; kín lịch, không rảnh	TẮC
隔たる	へだたる	ngăn cách; cách biệt, cách xa	CÁCH
隔たる	へだたる	khác biệt	CÁCH
吠える	ほえる	sủa	PHỆ
誇る	ほこる	tự hào, kiêu hãnh	KHOA
ほっとする		nhẹ nhõm, yên tâm	
満たす	みたす	đổ đầy; làm đầy, làm thỏa mãn	MÃN
満ちる	みちる	đầy, tràn đầy	MÃN
剥がす	はがす	tháo, bóc, gỡ	BÁC
凹む	へこむ	lõm; buồn, suy sụp	AO
実る	みのる	chín; mang lại kết quả tốt	THỰC
潜る	もぐる	lặn xuống, chui vào, rúc xuống; giấu mình, trốn	TIỀM
用いる	もちいる	sử dụng, tận dụng	DỤNG
透き通る	すきとおる	trong suốt, trong trẻo	THẤU THÔNG
突き当たる	つきあたる	đâm vào;	ĐỘT ĐƯƠNG
突き当たる	つきあたる	vấp phải	ĐỘT ĐƯƠNG
命じる	めいじる	ra lệnh, chỉ thị	MỆNH
詫びる	わびる	xin lỗi, tạ lỗi	SÁ
相次ぐ	あいつぐ	liên tiếp xảy ra	TƯƠNG THỨ
当てはまる	あてはまる	phù hợp, thích hợp	ĐƯƠNG
当てはめる	あてはめる	áp dụng, đưa vào	ĐƯƠNG
言い付ける	いいつける	ra lệnh, sai bảo;	NGÔN PHÓ
行き着く	いきつく	đi đến, cuối cùng thì đến	HÀNH TRỨ
入れ替える	いれかえる	thay đổi vị trí, thay đổi cái cũ lấy cái mới	NHẬP THẾ
打ち明ける	うちあける	thổ lộ, bộc bạch	ĐẢ MINH
上回る	うわまわる	vượt quá, nhiều hơn	THƯỢNG HỒI
噛みつく	かみつく	cắn; phản ứng dữ dội	GIẢO
考え込む	かんがえこむ	suy nghĩ miên man, trầm tư	KHẢO NHẬP
感じ取る	かんじとる	cảm nhận, nắm bắt	CẢM THỦ
聞き返す	ききかえす	hỏi lại, nghe lại	VĂN PHẢN
切り替える	きりかえる	chuyển đổi, thay đổi	THIẾT THẾ
心得る	こころえる	hiểu rõ, nắm được	TÂM ĐẮC
差し引く	さしひく	trừ đi, khấu trừ	SAI DẪN
締めくくる	しめくくる	kết thúc, tổng kết	ĐẾ
再開	さいかい	mở lại, khởi động lại	TÁI KHAI
再発	さいはつ	tái phát, xảy ra lại	TÁI PHÁT
貯蔵	ちょぞう	tàng trữ, lưu trữ	TRỮ TÀNG
侵入	しんにゅう	xâm nhập, đột nhập	XÂM NHẬP
説得	せっとく	thuyết phục	THUYẾT ĐẮC
洗面	せんめん	rửa mặt	TẨY DIỆN
創作	そうさく	sáng tác, tạo ra	SÁNG TÁC
想定	そうてい	giả định, dự tính trước	TƯỞNG ĐỊNH
相反	そうはん	mâu thuẫn, đối lập	TƯƠNG PHẢN
創立	そうりつ	thành lập	SÁNG LẬP
遭難	そうなん	thảm họa, tai nạn	TAO NAN
通知	つうち	thông báo	THÔNG TRI
固定	こてい	cố định, giữ nguyên	CỐ ĐỊNH
蓄積	ちくせき	tích lũy, lưu trữ	SÚC TÍCH
到達	とうたつ	đạt được, đến nơi	ĐÁO ĐẠT
再〜	さい〜	chỉ sự lặp lại, làm lại, xảy ra lần nữa	TÁI
片方	かたほう	một bên, một chiếc	PHIẾN PHƯƠNG
限定版	げんていばん	phiên bản giới hạn	HẠN ĐỊNH BẢN
隅々	すみずみ	mọi ngóc ngách, khắp nơi	NGUNG
迷信	めいしん	mê tín	MÊ TÍN
迷路	めいろ	mê cung	MÊ LỘ
迷惑行為	めいわくこうい	hành vi gây phiền phức	MÊ HOẶC HÀNH VI
途中	とちゅう	giữa chừng, giữa đường, trên đường	ĐỒ TRUNG
自治体	じちたい	chính quyền địa phương	TỰ TRỊ THỂ
重点	じゅうてん	trọng điểm, điểm quan trọng	TRỌNG ĐIỂM
重量	じゅうりょう	trọng lượng	TRỌNG LƯỢNG
重力	じゅうりょく	trọng lực	TRỌNG LỰC
情	じょう	tình cảm, cảm xúc	TÌNH
蒸気	じょうき	hơi nước	CHƯNG KHÍ
女王	じょおう	nữ hoàng	NỮ VƯƠNG
助手	じょしゅ	trợ lý	TRỢ THỦ
カルチャーショック		sốc văn hóa	
ガードマン		bảo vệ	
高性能	こうせいのう	hiệu suất cao	CAO TÍNH NĂNG
プレゼン		thuyết trình	presentation
プロセス		quy trình	process
順序	じゅんじょ	tuần tự, trình tự	THUẬN TỰ
需要	じゅよう	nhu cầu	NHU YẾU
穀物	こくもつ	ngũ cốc	CỐC VẬT
主語	しゅご	chủ ngữ	CHỦ NGỮ
過度	かど	quá mức	QUÁ ĐỘ
強大	きょうだい	hùng mạnh	CƯỜNG ĐẠI
強力	きょうりょく	mạnh, mạnh mẽ	CƯỜNG LỰC
強烈	きょうれつ	mãnh liệt, dữ dội	CƯỜNG LIỆT
巨大	きょだい	khổng lồ, to lớn	CỰ ĐẠI
主要	しゅよう	chủ chốt, chủ yếu, quan trọng	CHỦ YẾU
途端	とたん	ngay khi, đúng lúc	ĐỒ ĐOAN
途方もない	とほうもない	phi thường, khổng lồ, quá sức tưởng tượng	ĐỒ PHƯƠNG
甚だしい	はなはだしい	quá mức, cực kỳ	THẬM
分厚い	ぶあつい	dày	PHÂN HẬU
曖昧	あいまい	mơ hồ, không rõ ràng	ÁI MUỘI
あやふや		mập mờ, không chắc chắn	
ありがち		dễ thấy, hay thấy	
円満	えんまん	hòa thuận, êm đẹp	VIÊN MÃN
大まか	おおまか	đại khái, sơ lược	ĐẠI
過激	かげき	quá khích, quá mức	QUÁ KÍCH
気の毒	きのどく	đáng tiếc, đáng thương	KHÍ ĐỘC
客観的	きゃっかんてき	mang tính khách quan	KHÁCH QUAN ĐÍCH
急激	きゅうげき	đột ngột, nhanh chóng	CẤP KÍCH
懸命	けんめい	hết sức mình, nỗ lực hết mình	HUYỀN MỆNH
厳重	げんじゅう	nghiêm ngặt	NGHIÊM TRỌNG
公正	こうせい	công bằng	CÔNG CHÍNH
最適	さいてき	thích hợp nhất	TỐI THÍCH
ささやか		nhỏ, ít ỏi, mộc mạc	
主観的	しゅかんてき	mang tính chủ quan	CHỦ QUAN ĐÍCH
豪華	ごうか	xa xỉ, sang trọng, hoành tráng	HÀO HOA
軟弱	なんじゃく	yếu; nhu nhược	NHUYỄN NHƯỢC
合理的	ごうりてき	hợp lý, logic	HỢP LÝ ĐÍCH
幸い	さいわい	may, may mắn	HẠNH
付け加える	つけくわえる	thêm vào	PHÓ GIA
突っ込む	つっこむ	vặn hỏi, hỏi sâu;	ĐỘT
積み重なる	つみかさなる	chất chồng	TÍCH TRỌNG
積み重ねる	つみかさねる	chất lên; tích luỹ	TÍCH TRỌNG
釣り合う	つりあう	cân đối, tương xứng	ĐIẾU HỢP
出くわす	でくわす	tình cờ, bất ngờ gặp	XUẤT
揃える	そろえる	đồng bộ, thống nhất; chuẩn bị; sắp xếp	TIỄN
蓄える	たくわえる	tích trữ, dự trữ	SÚC
看病	かんびょう	chăm sóc người bệnh	KHÁN BỆNH
帰省	きせい	về quê	QUY TỈNH
改造	かいぞう	cải tạo, cải tổ, chỉnh sửa	CẢI TẠO
移行	いこう	chuyển đổi	DI HÀNH
実感	じっかん	cảm nhận thực sự	THỰC CẢM
熟成	じゅくせい	lên men, ủ; chín	THỤC THÀNH
上映	じょうえい	chiếu phim	THƯỢNG ÁNH
上京	じょうきょう	lên tokyo	THƯỢNG KINH
蒸発	じょうはつ	bốc hơi	CHƯNG PHÁT
克服	こくふく	khắc phục, vượt qua	KHẮC PHỤC
主〜	しゅ〜	Chính, chủ yếu	CHỦ
〜版	〜ばん	phiên bản ~	BẢN
〜上	〜じょう	Về mặt ~, trên phương diện ~	THƯỢNG
構造	こうぞう	cấu trúc, cấu tạo, kết cấu	CẤU TẠO
軒	のき	mái hiên, hiên nhà	HIÊN
金庫	きんこ	két sắt	KIM KHỐ
軍隊	ぐんたい	quân đội	QUÂN ĐỘI
逆効果	ぎゃくこうか	tác dụng ngược lại, phản tác dụng	NGHỊCH HIỆU QUẢ
航空	こうくう	hàng không	HÀNG KHÔNG
鉱物	こうぶつ	khoáng vật	KHOÁNG VẬT
銅メダル	どうメダル	huy chương đồng	ĐỒNG
革製	かわせい	làm bằng da	CÁCH CHẾ
人混み	ひとごみ	đám đông	NHÂN HỖN
温暖化	おんだんか	sự nóng lên toàn cầu	ÔN NOÃN HÓA
人事	じんじ	nhân sự	NHÂN SỰ
人類	じんるい	loài người	NHÂN LOẠI
吸い殻	すいがら	mẩu thuốc lá hút dở	HẤP XÁC
水産	すいさん	thủy sản	THỦY SẢN
水蒸気	すいじょうき	hơi nước	THỦY CHƯNG KHÍ
水面	すいめん	mặt nước	THỦY DIỆN
数値	すうち	giá trị số, số liệu	SỐ TRỊ
数人	すうにん	vài người	SỐ NHÂN
隙間	すきま	khe hở, khoảng trống	KHÍCH GIAN
滑り止め	すべりどめ	miếng chống trượt, chất chống trượt; phương án dự phòng	HOẠT CHỈ
極み	きわみ	cực kỳ, hết sức, vô cùng	CỰC
シャッター		cửa cuốn, màn trập	shutter
シンポジウム		hội thảo chuyên đề	symposium
コラム		chuyên mục	column
コレクション		bộ sưu tập	collection
コンクリート		bê tông	concrete
水平	すいへい	mặt phẳng ngang, mức ngang	THỦY BÌNH
鈍感	どんかん	kém nhạy cảm, vô cảm	ĐỘN CẢM
大らか	おおらか	rộng lượng, phóng khoáng	ĐẠI
瞬間的	しゅんかんてき	mang tính tức thời	THUẤN GIAN ĐÍCH
全面的	ぜんめんてき	toàn diện	TOÀN DIỆN ĐÍCH
構う	かまう	quan tâm, để ý, bận tâm	CẤU
導く	みちびく	dẫn dắt, chỉ dẫn	ĐẠO
創造	そうぞう	sự sáng tạo, tạo ra cái mới	SÁNG TẠO
遅延	ちえん	sự trì hoãn, chậm trễ	TRÌ DUYÊN
比較	ひかく	so sánh	TỶ GIÁC
休講	きゅうこう	nghỉ, nghỉ học	HƯU GIẢNG
講演	こうえん	buổi diễn thuyết, thuyết trình	GIẢNG DIỄN
欠航	けっこう	hủy chuyến	KHIẾM HÀNG
養成	ようせい	đào tạo, bồi dưỡng	DƯỠNG THÀNH
注射	ちゅうしゃ	tiêm	CHÚ XẠ
発射	はっしゃ	bắn, phóng	PHÁT XẠ
上達	じょうたつ	tiến bộ	THƯỢNG ĐẠT
衰退	すいたい	suy thoái, suy yếu	SUY THOÁI
必ずしも	かならずしも	không hẳn, chưa chắc	TẤT
軽々	かるがる	nhẹ nhàng, dễ dàng	KHINH
がっしり		vững chắc, rắn rỏi	
急速に	きゅうそくに	một cách nhanh chóng	CẤP TỐC
きらきら		lấp lánh	
ぎざぎざ		có răng cưa, lởm chởm	
ぎしぎし		kẽo kẹt, cót két	
くれぐれも		rất mong, xin hãy (lịch sự)	
ぐるぐる		vòng vòng, quay tròn	
ぐんぐん		nhanh chóng, vùn vụt	
現に	げんに	thực sự, trên thực tế	HIỆN
強引に	ごういんに	cưỡng ép, bắt buộc	CƯỜNG DẪN
ごくごく		ừng ực	
逆様に	さかさまに	ngược, đảo lộn	NGHỊCH DẠNG
しいんと		im phăng phắc	
しきりに		liên tục, không ngừng	
しっとり		ẩm mượt, yên tĩnh	
知らず知らず	しらずしらず	vô thức, không nhận ra	TRI
直ちに	ただちに	ngay lập tức	TRỰC
じめじめ		ẩm ướt, ủ rũ	
じりじり		(ánh nắng) chiếu mạnh; tiến lại dần dần	
じろじろ		nhìn chằm chằm	
すいすい		trôi chảy, trơn tru, thuận lợi	
すらすら		suôn sẻ, mạch lạc	
ぜひとも		nhất định, bằng mọi giá	
諸〜	しょ〜	nhiều, đa dạng, các…	CHƯ
多〜	た〜	nhiều, đa…	ĐA
低〜	てい〜	thấp…	ĐÊ
最〜	さい〜	…nhất	TỐI
同〜	どう〜	cùng, giống, đồng…	ĐỒNG
〜一色	〜いっしょく	hoàn toàn, toàn bộ (thường đi kèm với một danh từ biểu thị đặc điểm để nhấn mạnh trạng thái bao phủ toàn bộ)	NHẤT SẮC
瓦	かわら	ngói	NGÕA
瓶	びん	chai, lọ	BÌNH
鉄砲	てっぽう	súng	THIẾT PHÁO
奥底	おくそこ	đáy sâu, nơi sâu kín	ÁO ĐỂ
庭園	ていえん	vườn, khuôn viên	ĐÌNH VIÊN
気象庁	きしょうちょう	cục khí tượng thuỷ văn	KHÍ TƯỢNG SẢNH
一言	ひとこと	một lời, đôi lời	NHẤT NGÔN
悪魔	あくま	ác ma, ma quỷ	ÁC MA
湯気	ゆげ	hơi nước	THANG KHÍ
近頃	ちかごろ	dạo gần đây	CẬN KHOẢNH
大半	たいはん	đa phần, phần lớn	ĐẠI BÁN
大部分	だいぶぶん	đại đa số, phần lớn	ĐẠI BỘ PHẬN
不可	ふか	không thể	BẤT KHẢ
アクシデント		tai nạn, sự cố	accident
ピーク	ピーク	đỉnh điểm, cao trào	peak
ワールド	ワールド	thế giới	world
インパクト		tác động, ảnh hưởng mạnh	impact
アリバイ		chứng cứ ngoại phạm	alibi
インテリア		nội thất	interior
自ら	みずから	chính mình, bản thân; tự mình	TỰ
不運	ふうん	xui xẻo, bất hạnh	BẤT VẬN
不可欠	ふかけつ	không thể thiếu	BẤT KHẢ KHIẾM
能率的	のうりつてき	hiệu quả	NĂNG SUẤT ĐÍCH
本格的	ほんかくてき	chính thức, thực sự	BẢN CÁCH ĐÍCH
前向き	まえむき	tích cực, hướng về phía trước	TIỀN HƯỚNG
呑気	のんき	vô lo, thảnh thơi	THÔN KHÍ
ばりばり		(nhai) rộp rộp, chăm chỉ, hăng hái;	
ひたすら		dốc sức, chuyên tâm, một lòng	
びりびり		xé nát, te tua; (rung) bần bật; tê rần, giật tê	
抱える	かかえる	ôm, cầm trong tay; gánh vác, đối mặt	BÃO
傷む	いたむ	hư, hỏng	THƯƠNG
承る	うけたまわる	hiểu, tiếp nhận	THỪA
痺れる	しびれる	tê, tê liệt	TÝ
ぞっとする		rùng mình, sợ hãi	
疲労	ひろう	sự mệt mỏi, kiệt sức	BÌ LAO
労働	ろうどう	sự lao động, làm việc	LAO ĐỘNG
終了	しゅうりょう	kết thúc	CHUNG LIỄU
完了	かんりょう	hoàn thành	HOÀN LIỄU
了解	りょうかい	hiểu rõ, đồng ý	LIỄU GIẢI
伝承	でんしょう	truyền lại, kế thừa	TRUYỀN THỪA
承認	しょうにん	phê duyệt, thừa nhận	THỪA NHẬN
取得	しゅとく	giành được, lấy được	THỦ ĐẮC
アプローチ		sự tiếp cận, tiến lại gần	approach
インストール		cài đặt	install
ケア		chăm sóc	care
確保	かくほ	bảo đảm, giữ	XÁC BẢO
発行	はっこう	phát hành, cấp phát	PHÁT HÀNH
近々	ちかぢか	sắp tới, chẳng bao lâu	CẬN
つくづく		thấm thía, sâu sắc	
残らず	のこらず	tất cả, toàn bộ	TÀN
はるかに		hơn hẳn, vượt xa	
ばっさり		cắt mạnh, cắt phăng, dứt khoát	
一通り	ひととおり	sơ lược, một lượt	NHẤT THÔNG
到底	とうてい	hoàn toàn không thể	ĐÁO ĐỂ
ふわふわ		bồng bềnh, mềm mại	
ふんわり		nhẹ nhàng, mềm mại	
ほかほか		ấm áp, ấm nóng	
まさに		đúng là, chính là	
めっきり		rõ rệt, hẳn	
ゆったり		rộng rãi; thong thả	
わりと		khá là, tương đối	
めったに		hiếm khi	
やがて		chẳng mấy mà, cuối cùng	
ふと		đột nhiên, bất chợt	
むしろ		thay vào đó, ngược lại, đúng ra thì...	
ついつい		vô tình, lỡ (làm gì đó)	
〜流	～りゅう	phong cách, trường phái, cách làm ~	LƯU
〜量	～りょう	lượng, khối lượng, số lượng của một thứ gì đó	LƯỢNG
〜力	～りょく	khả năng, sức mạnh, năng lực liên quan đến một lĩnh vực	LỰC
〜類	～るい	loại, chủng loại — dùng để chỉ nhóm, hạng mục, hoặc thể loại của một sự vật/sinh vật.	LOẠI
業務	ぎょうむ	nghiệp vụ, công việc	NGHIỆP VỤ
実務	じつむ	công việc thực tế, cụ thể	THỰC VỤ
現段階	げんだんかい	giai đoạn hiện nay	HIỆN ĐOẠN GIAI
参加賞	さんかしょう	phần thưởng cho người tham gia	THAM GIA THƯỞNG
州	しゅう	bang, châu	CHÂU
一戸建て	いっこだて	căn nhà riêng, nhà biệt lập	NHẤT HỘ KIẾN
外交	がいこう	ngoại giao	NGOẠI GIAO
癌	がん	ung thư	NHAM
傑作	けっさく	kiệt tác, tác phẩm xuất sắc	KIỆT TÁC
定価	ていか	giá niêm yết	ĐỊNH GIÁ
磁石	じしゃく	nam châm	TỪ THẠCH
唾	つば	nước bọt	THÓA
翼	つばさ	đôi cánh	DỰC
停留所	ていりゅうじょ	trạm xe buýt	ĐÌNH LƯU SỞ
哲学	てつがく	triết học	TRIẾT HỌC
弟子	でし	học trò, đệ tử	ĐỆ TỬ
ウェブページ		trang web	
エコノミー		hạng thường, hạng phổ thông; kinh tế, quản lý tài chính	economy
エピソード		câu chuyện, tập, chương	episode
カウンセリング		tư vấn, khuyến cáo	Counseling
カリキュラム		giáo án, giáo trình, chương trình học	curriculum
オーケストラ		dàn nhạc giao hưởng	orchestra
オリエンテーション		buổi định hướng	orientation
オルガン		đàn organ	organ
カーシェアリング		dịch vụ chia sẻ xe	carsharing
カウンセラー		nhà tư vấn	counselor
一石二鳥	いっせきにちょう	một công đôi việc	NHẤT THẠCH NHỊ ĐIỂU
物心	ものごころ	nhận thức	VẬT TÂM
土台	どだい	nền tảng, cơ sở	THỔ ĐÀI
道徳	どうとく	đạo đức	ĐẠO ĐỨC
噴水	ふんすい	đài phun nước	PHÚN THỦY
不祥事	ふしょうじ	vụ bê bối, sự cố	BẤT TƯỜNG SỰ
船便	ふなびん	gửi bằng đường biển	THUYỀN TIỆN
吹雪	ふぶき	bão tuyết	XUY TUYẾT
大陸	たいりく	lục địa	ĐẠI LỤC
鹿	しか	con nai, con hươu	LỘC
旗	はた	lá cờ	KỲ
裸	はだか	trần truồng, khỏa thân	LỎA
オリジナル		nguyên bản, gốc; độc quyền	
モダン		hiện đại	
凸凹	でこぼこ	sự chênh lệch; lồi lõm, gập ghềnh	ĐỘT AO
永久	えいきゅう	vĩnh cửu, mãi mãi	VĨNH CỬU
半永久	はんえいきゅう	bán vĩnh cửu, gần như vĩnh viễn	BÁN VĨNH CỬU
乏しい	とぼしい	nghèo nàn, thiếu thốn	PHẠP
勤務	きんむ	công việc, sự làm việc	CẦN VỤ
批判	ひはん	đánh giá, phê phán, chỉ trích	PHÊ PHÁN
診察	しんさつ	khám bệnh	CHẨN SÁT
受診	じゅしん	đi khám bệnh	THỤ CHẨN
検診	けんしん	kiểm tra sức khỏe, khám tổng quát	KIỂM CHẨN
参観	さんかん	quan sát, tham quan, dự	THAM QUAN
持参	じさん	mang theo, đem theo	TRÌ THAM
持続	じぞく	kéo dài	TRÌ TỤC
手当	てあて	tiền công, thù lao; trợ cấp, phụ cấp; chữa trị, sơ cứu; chuẩn bị	THỦ ĐƯƠNG
訂正	ていせい	chỉnh sửa, hiệu đính	ĐÍNH CHÍNH
救助	きゅうじょ	cứu trợ, cứu giúp	CỨU TRỢ
適用	てきよう	áp dụng	THÍCH DỤNG
添加	てんか	chất phụ gia; thêm vào	THIÊM GIA
噴火	ふんか	phun trào núi lửa	PHÚN HỎA
形成	けいせい	hình thành	HÌNH THÀNH
観察	かんさつ	quan sát	QUAN SÁT
混ざる	まざる	lẫn vào, trộn lẫn	HỖN
種をまく	たねをまく	gieo hạt	CHỦNG
根付く	ねづく	bén rễ, bắt rễ; ăn sâu	CĂN PHÓ
品がある	ひんがある	thanh lịch, tao nhã, có phẩm cách	PHẨM
耕す	たがやす	cày cấy, canh tác	CANH
ぶら下がる	ぶらさがる	treo lủng lẳng, đu bám	HẠ
ぶら下げる	ぶらさげる	treo, đeo vào	HẠ
襲う	おそう	tấn công; đột ngột kéo tới, ập đến	TẬP
脅かす	おびやかす	đe dọa, uy hiếp; làm giật mình, bất ngờ	HIẾP
仮〜	かり〜	tạm thời, chưa chính thức	GIẢ
〜全般	〜ぜんぱん	toàn bộ, toàn thể	TOÀN BÀN
〜育ち	〜そだち	lớn lên tại ~, trưởng thành ở ~	DỤC
〜付き	〜つき	kèm theo ~, có kèm ~	PHÓ
〜漬け	〜づけ	ngâm trong, chìm trong ~	TÍ
〜派	〜は	phe phái, trường phái	PHÁI
〜発	〜はつ	xuất phát từ…	PHÁT
〜風	〜ふう	phong cách, kiểu…	PHONG
〜不明	〜ふめい	không rõ, không xác định	BẤT MINH